‘탈시설	‘/SN+탈시설/NNG
장애인	장애인/NNG
커플	커플/NNG
자립생활	자립생활/NNG
포토전’	포토전/NNG+’/SN

장애우권익문제연구소	장애우권익문제연구소/NNG
서울지소는	서울/NNP+지소/NNG+는/JX
오는	오/VV+는/ETM
26일부터	26/SN+일/NNB+부터/JX
12월	12/SN+월/NNB
7일까지	7/SN+일/NNB+까지/JX
문래	문래/NNG
예술공장	예술공장/NNG
3층	3/SN+층/NNG
포켓갤러리에서	포켓갤러리/NNG+에서/JKB
‘탈시설	‘/SN+탈시설/NNG
장애인	장애인/NNG
커플	커플/NNG
자립생활	자립생활/NNG
포토전’을	포토전’/NNG+을/JKO
갖는다	갖/VV+는다/EF

이번	이번/NNG
포토전은	포토전/NNG+은/JX
탈시설	탈시설/NNG
장애인들의	장애인/NNG+들/XSN+의/JKG
일상과	일상/NNG+과/JC
추억을	추억/NNG+을/JKO
사진에	사진/NNG+에/JKB
담아	담/VV+아/EC
전시함으로써	전시하/VV+ㅁ/ETN+으로써/JKB
‘자유로운	‘/SL+자유롭/VA+ㄴ/ETM
삶’의	삶/NNG+’/SL+의/JKG
가치를	가치/NNG+를/JKO
환기시키고,	환기/NNG+시키/XSV+고/EC+,/SP
자립생활의	자립생활/NNG+의/JKG
중요성을	중요성/NNG+을/JKO
알리고자	알리/VV+고자/EC
기획됐다	기획되/VV+었/EP+다/EF

포토전	포토전/NNG
오픈식은	오픈/NNG+식/XSN+은/JX
26일	26/SN+일/NNB
오후	오후/NNG
7시	7/SN+시/NNB
진행될	진행되/VV+ㄹ/ETM
예정이다	예정/NNG+이/VCP+다/EC
