미국	미국/NNP
장애인자립센터	장애인자립센터/NNG
긍정적·부정적	긍정적/NNG+·/SP+부정/NNG+적/XSN
측면	측면/NNG
혼재	혼재/NNG

'2012	'/SS+2012/SN
장애청년드림팀	장애청년드림팀/NNG
6대륙에	6/SN+대륙/NNG+에/JKB
도전하다'의	도전하/VA+다/EF+'/SS+의/JKG
‘Indy팀’이	‘Indy/SL+팀/NNG+’/SL+이/JKS
최근	최근/NNG
서울	서울/NNP
여의도	여의도/NNP
이룸센터에서	이룸센터/NNG+에서/JKB
한국장애인자립생활총연합회(이하	한국장애인자립생활총연합회/NNP+(/SS+이하/NNG
한자연)	한자연/NNP+)/SS
안진환	안진환/NNP
대표와	대표/NNG+와/JC
만남을	만남/NNG+을/JKO
가졌다	가지/VV+었/EP+다/EC

이날	이날/NNG
Indy팀은	Indy/SL+팀/NNG+은/JX
오는	오/VV+는/ETM
8월	8/SN+월/NNB
26일부터	26/SN+일/NNB+부터/JX
9월	9/SN+월/NNB
4일까지	4/SN+일/NNB+까지/JX
'미국	'/SS+미국/NNP
장애인자립생활센터	장애인자립생활센터/NNG
체험'이라는	체험/NNG+'/SS+이/VCP+라는/ETM
주제로	주제/NNG+로/JKB
떠나는	떠나/VV+는/ETM
미국	미국/NNP
연수에	연수/NNG+에/JKB
대해	대하/VV+여/EC
간략히	간략히/MAG
소개했다	소개하/VV+였/EP+다/EC

이어	이어/MAG
국내	국내/NNG
장애인자립생활센터의	장애인자립생활센터/NNG+의/JKG
현주소를	현주소/NNG+를/JKO
물은	묻/VV+은/ETM
뒤	뒤/NNG
연수와	연수/NNG+와/JKB
관련된	관련되/VV+ㄴ/ETM
조언을	조언/NNG+을/JKO
구했다	구하/VV+였/EP+다/EC

안	안/NNP
대표는	대표/NNG+는/JX
“미국의	“/SN+미국/NNP+의/JKG
자립생활센터가	자립생활센터/NNG+가/JKS
전반적으로	전반적/NNG+으로/JKB
국내보다	국내/NNG+보다/JKB
더	더/MAG
선진적인	선진적/NNG+이/VCP+ㄴ/ETM
시스템과	시스템/NNG+과/JC
많은	많/VA+은/ETM
노하우가	노하우/NNG+가/JKS
있고,	있/VA+고/EC+,/SP
사회적	사회적/NNG
인프라가	인프라/NNG+가/JKS
잘	잘/MAG
구축되어서	구축되/VV+어서/EC
비교적	비교적/NNG
활성화된	활성화되/VV+ㄴ/ETM
편”이라고	편”/NNG+이/VCP+라고/EC
언급하면서	언급하/VV+면서/EC
“그런	“그럽/VA+ㄴ/ETM
좋은	좋/VA+은/ETM
여건	여건/NNG
외에도	외/NNB+에/JKB+도/JX
부정적인	부정적/NNG+이/VCP+ㄴ/ETM
측면도	측면/NNG+도/JX
있기	있/VA+기/ETN
때문에	때문/NNB+에/JKB
객관적인	객관적/NNG+이/VCP+ㄴ/ETM
입장에서	입장/NNG+에서/JKB
두루	두루/MAG
체험해야	체험하/VV+여야/EC
할	하/VX+ㄹ/ETM
것”이라고	것/NNB+”/SL+이/VCP+라고/EC
조언했다	조언하/VV+였/EP+다/EF

또한	또한/MAG
“보통	“/SL+보통/NNG
미국이라는	미국/NNP+이/VCP+라는/ETM
환상	환상/NNG
속에서	속/NNG+에서/JKB
무조건	무조건/MAG
좋은	좋/VA+은/ETM
측면만이	측면/NNG+만/JX+이/JKS
있을	있/VA+을/ETM
것이라는	것/NNB+이/VCP+라는/ETM
생각을	생각/NNG+을/JKO
하지만,	하/VV+지만/EC+,/SP
실상	실상/MAG
거기에서도	거기/NP+에서/JKB+도/JX
단점은	단점/NNG+은/JX
존재하며	존재하/VV+며/EC
실제적으로	실제/NNG+적/XSN+으로/JKB
미국이	미국/NNP+이/JKS
넓고	넓/VA+고/EC
다양한	다양하/VA+ㄴ/ETM
사람들이	사람/NNG+들/XSN+이/JKS
있는	있/VA+는/ETM
곳이라	곳/NNG+이/VCP+라/EC
많은	많/VA+은/ETM
사례가	사례/NNG+가/JKS
있을	있/VA+을/ETM
것”이라고	것/NNB+”/SL+이/VCP+라고/EC
덧붙였다	덧붙이/VV+었/EP+다/EF

특히	특히/MAG
안	안/NNP
대표는	대표/NNG+는/JX
한자연과	한자연/NNG+과/JC
교류를	교류/NNG+를/JKO
하고	하/VV+고/EC
있는	있/VX+는/ETM
글렌	글렌/NNP
화이트(Glen	화이트/NNG+(/SS+Glen/SL
White)캔자스대학	White/SL+)/SS+캔자스대학/NNP
교수와의	교수/NNG+와/JKB+의/JKG
만남을	만남/NNG+을/JKO
추천하면서	추천하/VV+면서/EC
LA뿐만	LA/SL+뿐만/JX
아니라	아니/VCN+라/EC
미국	미국/NNP
중부	중부/NNG
캔자스에도	캔자스/NNP+에/JKB+도/JX
방문해	방문하/VV+여/EC
체험할	체험하/VV+ㄹ/ETM
것을	것/NNB+을/JKO
당부했다	당부하/VV+였/EP+다/EC

여기에	여기/NP+에/JKB
연수	연수/NNG
출발	출발/NNG
전	전/NNG
사전	사전/NNG
준비에	준비/NNG+에/JKB
만전을	만전/NNG+을/JKO
기할	기하/VV+ㄹ/ETM
것과	것/NNB+과/JKB
함께	함께/MAG
더	더/MAG
많은	많/VA+은/ETM
정보와	정보/NNG+와/JC
조언을	조언/NNG+을/JKO
얻기	얻/VV+기/ETN
위해	위하/VV+여/EC
고관철	고관철/NNG
전	전/MM
한자연대표와의	한자연대표/NNG+와/JKB+의/JKG
만남도	만남/NNG+도/JX
주문했다	주문하/VV+였/EP+다/EF

이	이/MM
밖에도	밖/NNG+에/JKB+도/JX
안	안/NNP
대표는	대표/NNG+는/JX
“연수에	“/SL+연수/NNG+에/JKB
있어서	있/VA+어서/EC
장애인자립생활센터에만	장애인자립생활센터/NNG+에/JKB+만/JX
초점을	초점/NNG+을/JKO
맞추지	맞추/VV+지/EC
말고	말/VX+고/EC
그	그/MM
외적인	외적/NNG+이/VCP+ㄴ/ETM
배경에도	배경/NNG+에/JKB+도/JX
관심을	관심/NNG+을/JKO
가져야	가지/VV+어야/EC
한다”면서	하/VX+ㄴ다/EF+”/XSN+면서/EC
“연금제도,	“/SL+연금제도/NNG+,/SP
지원	지원/NNG
수당	수당/NNG
등	등/NNB
장애인복지를	장애인복지/NNG+를/JKO
비롯한	비롯하/VV+ㄴ/ETM
여러	여러/MM
정보를	정보/NNG+를/JKO
조사할	조사하/VV+ㄹ/ETM
필요가	필요/NNG+가/JKS
있다”고	있/VA+다”고/EC
말했다	말하/VV+였/EP+다/EC

*이글은	*/SW+이글/NNP+은/JX
'2012장애청년드림팀	'/SS+2012/SN+장애/NNB+청년드림팀/NNG
6대륙에	6/SN+대륙/NNG+에/JKB
도전하다'	도전하/VA+다/EF+'/SS
‘Indy팀’의	‘Indy/SL+팀/NNG+’/SL+의/JKG
정승락님이	정승락/NNP+님/XSN+이/JKS
보내왔습니다	보내오/VV+았/EP+습니다/EF
