KBS	KBS/SL
TV소설	TV/SL+소설/NNG
‘사랑아	‘/SN+사랑아/NNG
사랑아’의	사랑아/NNP+’/SL+의/JKG
자원봉사자	자원봉사자/NNG

자원봉사자(自願奉仕者,	자원봉사자/NNG+(/SS+自願奉仕者/SL+,/SP
Volunteer)란	Volunteer/SL+)/SS+이/VCP+란/ETM
자기	자기/NP
스스로가	스스로/NNG+가/JKS
대가없이	대가/NNG+없이/MAG
자신의	자신/NNG+의/JKG
열정(재능)과	열정/NNG+(/SS+재능/NNG+)/SS+과/JC
시간과	시간/NNG+과/JC
돈을	돈/NNG+을/JKO
사회	사회/NNG
또는	또는/MAG
공공의	공공/NNG+의/JKG
이익을	이익/NNG+을/JKO
위해	위하/VV+여/EC
바치는	바치/VV+는/ETM
사람이다	사람/NNG+이/VCP+다/EC

예전에는	예전/NNG+에/JKB+는/JX
자원봉사자에	자원봉사자/NNG+에/JKB
대해	대하/VV+여/EC
문의	문의/NNG
하면서	하/VV+면서/EC
그거	그거/NP
하면	하/VV+면/EC
얼마	얼마/NNG
주느냐고	주/VX+느냐고/EC
묻는	묻/VV+는/ETM
사람들도	사람/NNG+들/XSN+도/JX
있었다	있/VA+었/EP+다/EF

20여	20/SN+여/XSN
년	년/NNB
전	전/NNG
자원봉사자가	자원봉사자/NNG+가/JKS
무슨	무슨/MM
의미인지	의미/NNG+이/VCP+ㄴ지/EC
잘	잘/MAG
몰랐을	모르/VV+았/EP+을/ETM
때이므로	때/NNG+이/VCP+므로/EC
더러는	더러/MAG+는/JX
보수를	보수/NNG+를/JKO
바라기도	바라/VV+기/ETN+도/JX
했던	하/VX+였/EP+던/ETM
것이다	것/NNB+이/VCP+다/EC

자원봉사자의	자원봉사자/NNG+의/JKG
유래	유래/NNG

ⓒ한국자원봉사연합회	ⓒ/SL+한국자원봉사연합회/NNP
자원봉사활동을	자원봉사활동/NNG+을/JKO
나타내는	나타내/VV+는/ETM
볼런타리즘(Voluntarism)	볼런타리즘/NNG+(/SS+Voluntarism/SL+)/SS
또는	또는/MAG
볼런티어리즘(Volunteerism)은	볼런티어리즘/NNG+(/SS+Volunteerism/SL+)/SS+은/JX
‘자유의지’라는	‘/SN+자유의지’/NNG+이/VCP+라는/ETM
라틴어	라틴/NNP+어/XSN
볼런타스(Voluntas)에서	볼런타스/NNG+(/SS+Voluntas/SL+)/SS+에서/JKB
유래되었다고	유래되/VV+었/EP+다고/EC
하는데,	하/VV+는데/EC+,/SP
사회	사회/NNG
또는	또는/MAG
이웃을	이웃/NNG+을/JKO
위해	위하/VV+여/EC
대가를	대가/NNG+를/JKO
바라지	바라/VV+지/EC
않고	않/VX+고/EC
도와주는	도와주/VV+는/ETM
사람은	사람/NNG+은/JX
인간의	인간/NNG+의/JKG
역사와	역사/NNG+와/JKB
함께	함께/MAG
시작되었을	시작되/VV+었/EP+을/ETM
것이다	것/NNB+이/VCP+다/EC

특히	특히/MAG
우리나라의	우리나라/NNG+의/JKG
건국이념이자	건국이념/NNG+이/VCP+자/EC
교육이념인	교육이념/NNG+이/VCP+ㄴ/ETM
‘널리	‘/SN+널리/NNG
인간을	인간/NNG+을/JKO
이롭게	이롭/VA+게/EC
한다’는	하/VX+ㄴ다/EF+’/SL+는/JX
홍익인간(弘益人間)은	홍익인간/NNG+(/SS+弘益人間/SL+)/SS+은/JX
인간애와	인간애/NNG+와/JC
이타주의에	이타주의/NNG+에/JKB
바탕하고	바탕/NNG+하/XSV+고/EC
있는	있/VX+는/ETM
자원봉사의	자원봉사/NNG+의/JKG
근간이기도	근간/NNG+이/VCP+기/ETN+도/JX
하다	하/VX+다/EC

그러나	그러나/MAJ
근대적	근대적/NNG
의미의	의미/NNG+의/JKG
볼런티어(Volunteer)는	볼런티어/NNG+(/SS+Volunteer/SL+)/SS+는/JX
1617년	1617/SN+년/NNB
영국에서	영국/NNP+에서/JKB
신부	신부/NNG
빈센트	빈센트/NNP
드	드/NNP
폴이	폴/NNP+이/JKS
조직한	조직하/VV+ㄴ/ETM
자선부인회에서	자선부인/NNG+회/XSN+에서/JKB
전개한	전개하/VV+ㄴ/ETM
사회봉사	사회봉사/NNG
활동이라	활동/NNG+이/VCP+라/EC
할	하/VV+ㄹ/ETM
수	수/NNB
있는데	있/VA+는데/EC
처음에는	처음/NNG+에/JKB+는/JX
자선사업가로	자선사업가/NNG+로/JKB
사회복지의	사회복지/NNG+의/JKG
주도적	주도적/NNG
역할을	역할/NNG+을/JKO
하였으나	하/VV+였/EP+으나/EC
차츰	차츰/MAG
볼런티어의	볼런티어/NNG+의/JKG
역할은	역할/NNG+은/JX
협력자로	협력자/NNG+로/JKB
바뀌게	바뀌/VV+게/EC
되었다고	되/VV+었/EP+다고/EC
한다	하/VV+ㄴ다/EF

이	이/NP
같은	같/VA+은/ETM
서양의	서양/NNG+의/JKG
볼런타리즘(voluntarism)은	볼런타리즘/NNG+(/SS+voluntarism/SL+)/SS+은/JX
우리나라에	우리나라/NNG+에/JKB
들어	들/VV+어/EC
온	오/VV+ㄴ/ETM
것은	것/NNB+은/JX
한말	한말/NNG
기독교	기독교/NNG
사상과	사상/NNG+과/JKB
같이	같이/MAG
들어	들/VV+어/EC
왔는데	오/VX+았/EP+는데/EC
당시에는	당시/NNG+에/JKB+는/JX
주로	주로/MAG
지식인들의	지식인/NNG+들/XSN+의/JKG
농촌계몽활동이었다	농촌계몽활동/NNG+이/VCP+었/EP+다/EF

그	그/MM
후	후/NNG
1960년대에	1960/SN+년대/NNB+에/JKB
인도주의와	인도주의/NNG+와/JC
자원봉사를	자원봉사/NNG+를/JKO
기본정신으로	기본정신/NNG+으로/JKB
하는	하/VV+는/ETM
적십자운동이	적십자운동/NNG+이/JKS
활성화	활성화/NNG
되면서	되/VV+면서/EC
각	각/MM
대학에서도	대학/NNG+에서/JKB+도/JX
농촌봉사활동이	농촌봉사활동/NNG+이/JKS
활발해져서	활발하/VA+여/EC+지/VX+어서/EC
이를	이/NP+를/JKO
‘농활’이라	‘/SL+농활’/NNG+이/VCP+라/EC
부르기도	부르/VV+기/ETN+도/JX
했다	하/VX+였/EP+다/EF

그리고	그리고/MAJ
’86아시안게임과	’/SL+86/SN+아시안게임/NNG+과/JC
’88올림픽을	’88/SN+올림픽/NNG+을/JKO
치르게	치르/VV+게/EC
되면서	되/VV+면서/EC
봉사자들을	봉사자/NNG+들/XSN+을/JKO
필요로	필요/NNG+로/JKB
하게	하/VV+게/EC
되자	되/VV+자/EC
그동안	그동안/NNG
일부	일부/NNG
사회복지기관	사회복지기관/NNG
등에서만	등/NNB+에서/JKB+만/JX
사용해	사용하/VV+여/EC
오던	오/VX+던/ETM
볼런티어가	볼런티어/NNG+가/JKS
‘자원봉사자’란	‘/SN+자원봉사자/NNG+’/SN+이/VCP+란/ETM
이름으로	이름/NNG+으로/JKB
인식되고	인식되/VV+고/EC
알려지게	알려지/VV+게/EC
되었으나,	되/VV+었/EP+으나/EC+,/SP
[자원봉사활동기본법]이	[/SS+자원봉사활동기본법/NNG+]/SS+이/JKS
제정된	제정되/VV+ㄴ/ETM
것은	것/NNB+은/JX
2005년	2005/SN+년/NNB
8월	8/SN+월/NNB
4일이다	4/SN+일/NNB+이/VCP+다/EC

사실	사실/MAG
필자도	필자/NNG+도/JX
사회복지	사회복지/NNG
특히	특히/MAG
장애인복지를	장애인복지/NNG+를/JKO
하게	하/VV+게/EC
된	되/VV+ㄴ/ETM
계기가	계기/NNG+가/JKS
1970년대에	1970/SN+년대/NNB+에/JKB
시작한	시작하/VV+ㄴ/ETM
자원봉사라고	자원봉사/NNG+이/VCP+라고/EC
할	하/VV+ㄹ/ETM
수	수/NNB
있다	있/VA+다/EC

녹음기도	녹음/VV+기/ETN+도/JX
귀했던	귀하/VA+였/EP+던/ETM
시절이라	시절/NNG+이/VCP+라/EC
시각장애인에게	시각장애인/NNG+에게/JKB
책을	책/NNG+을/JKO
읽어주는	읽/VV+어/EC+주/VX+는/ETM
낭독봉사활동을	낭독봉사활동/NNG+을/JKO
했었는데	하/VV+였었/EP+는데/EC
당시에도	당시/NNG+에/JKB+도/JX
낭독봉사자란	낭독봉사자/NNG+이/VCP+란/ETM
말은	말/NNG+은/JX
있었지만	있/VA+었/EP+지만/EC
‘자원봉사자’란	‘/SN+자원봉사자’/NNG+이/VCP+란/ETM
말은	말/NNG+은/JX
없었던	없/VA+었/EP+던/ETM
같다	같/VA+다/EC

‘사랑아	‘/SN+사랑아/NNG
사랑아’	사랑아’/NNG
홈페이지	홈페이지/NNG

ⓒKBS	ⓒKBS/SL
‘사랑아	‘/SL+사랑아/NNG
사랑아’	사랑아’/NNG
등장인물	등장인물/NNG
유씨	유/NNP+씨/NNB

ⓒKBS	ⓒKBS/SL
소설이나	소설/NNG+이나/JC
드라마는	드라마/NNG+는/JX
당연히	당연히/MAG
허구이다	허구/NNG+이/VCP+다/EC

그러나	그러나/MAJ
아무리	아무리/MAG
허구라	허구/NNG+이/VCP+라/EC
하더라도	하/VV+더라도/EC
사실적인	사실적/NNG+이/VCP+ㄴ/ETM
배경의	배경/NNG+의/JKG
바탕위에서	바탕위/NNG+에서/JKB
만들어진	만들/VV+어/EC+지/VX+ㄴ/ETM
허구여야	허구열/VV+야/EC
한다	하/VX+ㄴ다/EF

얼마	얼마/NNG
전에도	전/NNG+에/JKB+도/JX
필자가	필자/NNG+가/JKS
언급했듯이	언급하/VV+였/EP+듯이/EC
아무리	아무리/MAG
효를	효/NNG+를/JKO
강조하기	강조하/VV+기/ETN
위해서라도	위하/VV+여서/EC+라도/JX
살아있는	살/VV+아/EC+있/VX+는/ETM
어머니의	어머니/NNG+의/JKG
한쪽	한쪽/NNG
눈을	눈/NNG+을/JKO
아들에게	아들/NNG+에게/JKB
주어서는	주/VV+어서/EC+는/JX
안	안/MAG
된다는	되/VV+ㄴ다는/ETM
것이다	것/NNB+이/VCP+다/EC

살아있는	살/VV+아/EC+있/VX+는/ETM
사람의	사람/NNG+의/JKG
안구는	안구/NNG+는/JX
이식할	이식하/VV+ㄹ/ETM
수가	수/NNB+가/JKS
없기	없/VA+기/ETN
때문이다	때문/NNB+이/VCP+다/EC

KBS2	KBS/SL+2/SN
TV소설	TV/SL+소설/NNG
‘사랑아	‘/SN+사랑아/NNG
사랑아’는	사랑아/NNG+’/SL+는/JX
1970년대가	1970/SN+년대/NNB+가/JKS
시대적	시대적/NNG
배경인데	배경/NNG+이/VCP+ㄴ데/EC
출연자들이	출연자/NNG+들/XSN+이/JKS
그때는	그때/NNG+는/JX
사용하지도	사용하/VV+지/EC+도/JX
않았던	않/VX+았/EP+던/ETM
‘자원봉사자’를	‘/SN+자원봉사자’/NNG+를/JKO
남발하고	남발하/VV+고/EC
있으니	있/VX+으니/EC
말이다	말/NNG+이/VCP+다/EC

‘사랑아	‘/SN+사랑아/NNG
사랑아’는	사랑아’/NNG+는/JX
1970년대	1970/SN+년대/NNB
구미읍에서	구미읍/NNP+에서/JKB
떨어진	떨어지/VV+ㄴ/ETM
다미울이라는	다미울/NNG+이/VCP+라는/ETM
시골마을이	시골마을/NNG+이/JKS
주	주/NNG
무대인데	무대/NNG+이/VCP+ㄴ데/EC
다미울에서	다미울/NNP+에서/JKB
만복당이라는	만복당/NNP+이/VCP+라는/ETM
한약방을	한약방/NNG+을/JKO
운영하는	운영하/VV+는/ETM
홍윤식(선우재덕	홍윤식/NNP+(/SS+선우재덕/NNP
분)은	분/NNG+)/SS+은/JX
승희(황선희	승희/NNP+(/SS+황선희/NNP
분)와	분/NNG+)/SS+와/JC
승아(송민정	승아/NNG+(/SS+송민정/NNP
분)라는	분/NNB+)/SS+이/VCP+라는/ETM
쌍둥이	쌍둥이/NNG
딸과	딸/NNG+과/JC
아들	아들/NNG
하나를	하나/NR+를/JKO
두고	두/VV+고/EC
있다	있/VX+다/EC

언니	언니/NNG
승희는	승희/NNP+는/JX
공부를	공부/NNG+를/JKO
잘	잘/MAG
해서	하/VV+여서/EC
한국대를	한국/NNP+대/NNB+를/JKO
갔으나	가/VV+았/EP+으나/EC
동생	동생/NNG
승아는	승아/NNP+는/JX
중학교	중학교/NNG
밖에	밖/NNG+에/JKB
못	못/MAG
나온	나오/VV+ㄴ/ETM
말썽장이였다	말썽장/NNG+이/VCP+였다/EC

젊은	젊/VA+은/ETM
시절	시절/NNG
홍윤식과	홍윤식/NNP+과/JC
최명주(이일화	최명주/NNP+(/SS+이일화/NNP
분)는	분/NNG+)/SS+는/JX
사랑하는	사랑하/VV+는/ETM
사이였으나	사이/NNG+이/VCP+었/EP+으나/EC
독립운동을	독립운동/NNG+을/JKO
하던	하/VV+던/ETM
홍윤식의	홍윤식/NNP+의/JKG
아버지를	아버지/NNG+를/JKO
최명주의	최명주의/NNG
아버지가	아버지/NNG+가/JKS
밀고하는	밀고하/VV+는/ETM
바람에	바람/NNB+에/JKB
윤식의	윤식/NNG+의/JKG
아버지가	아버지/NNG+가/JKS
죽게	죽/VV+게/EC
되자	되/VV+자/EC
윤식의	윤식/NNG+의/JKG
어머니는	어머니/NNG+는/JX
두	두/MM
사람의	사람/NNG+의/JKG
결혼을	결혼/NNG+을/JKO
결사반대했다	결사반대하/VV+였/EP+다/EC

집안의	집안/NNG+의/JKG
반대로	반대/NNG+로/JKB
윤식은	윤식/NNG+은/JX
명주와	명주/NNP+와/JC
야반도주하여	야반도주/NNG+하/XSV+여/EC
살림을	살림/NNG+을/JKO
차렸고,	차리/VV+었/EP+고/EC+,/SP
명주가	명주/NNP+가/JKS
아이를	아이/NNG+를/JKO
가졌으나	가지/VV+었/EP+으나/EC
윤식은	윤식/NNG+은/JX
금동외삼촌(김효원	금동외삼촌/NNG+(/SS+김효원/NNP
분)에게	분/NNG+)/SS+에게/JKB
끌려와서	끌려오/VV+아서/EC
김양자(김예령	김양자/NNP+(/SS+김예령/NNP
분)과	분/NNG+)/SS+과/JKB
결혼하게	결혼하/VV+게/EC
된다	되/VV+ㄴ다/EF

그	그/MM
후	후/NNG
윤식은	윤식/NNG+은/JX
집	집/NNG
앞에서	앞/NNG+에서/JKB
강보에	강보/NNG+에/JKB
쌓인	쌓이/VV+ㄴ/ETM
아이를	아이/NNG+를/JKO
발견하고	발견하/VV+고/EC
양자가	양자/NNG+가/JKS
낳은	낳/VV+은/ETM
딸과	딸/NNG+과/JC
쌍둥이로	쌍둥이/NNG+로/JKB
키우는데,	키우/VV+는데/EC+,/SP
아기는	아기/NNG+는/JX
명주가	명주/NNG+가/JKS
수놓던	수놓/VV+던/ETM
배내저고리를	배내저고리/NNG+를/JKO
입고	입/VV+고/EC
있었다	있/VX+었/EP+다/EF

홍윤식과	홍윤식/NNP+과/JKB
헤어진	헤어지/VV+ㄴ/ETM
최명주가	최명주/NNP+가/JKS
아기를	아기/NNG+를/JKO
낳았으나	낳/VV+았/EP+으나/EC
명주	명주/NNP
엄마	엄마/NNG
유씨(김석옥	유/NNP+씨/NNB+(/SS+김석옥/NNP
분)는	분/NNG+)/SS+는/JX
명주에게는	명주/NNP+에게/JKB+는/JX
아기가	아기/NNG+가/JKS
죽었다고	죽/VV+었/EP+다고/EC
말하고,	말하/VV+고/EC+,/SP
명주의	명주/NNP+의/JKG
몸종이던	몸종/NNG+이/VCP+던/ETM
방곱단(이지은	방곱/NR+단/XSN+(/SS+이지/JC+은/JX
분)을	분/NNG+)/SS+을/JKO
시켜	시키/VV+어/EC
아기를	아기/NNG+를/JKO
윤식의	윤식/NNG+의/JKG
집	집/NNG
앞에	앞/NNG+에/JKB
갖다	갖/VV+다/EC
놓게	놓/VX+게/EC
했던	하/VX+였/EP+던/ETM
것이다	것/NNB+이/VCP+다/EC

그리고	그리고/MAJ
6	6/SN

25가	25/SN+가/JKS
터졌다	터지/VV+었/EP+다/EC

‘사랑아	‘/SN+사랑아/NNG
사랑아’	사랑아’/NNG
등장인물에	등장인물/NNG+에/JKB
있는	있/VA+는/ETM
설명을	설명/NNG+을/JKO
보면	보/VV+면/EC

‘유씨	‘/SL+유/NNP+씨/NNB
김석옥	김석옥/NNP

명주의	명주/NNP+의/JKG
어머니	어머니/NNG

서울	서울/NNP
근교의	근교/NNG+의/JKG
치매	치매/NNG
전문	전문/NNG
병원에	병원/NNG+에/JKB
장기	장기/NNG
입원	입원/NNG
중인	중/NNB+이/VCP+ㄴ/ETM
중증	중증/NNG
치매	치매/NNG
환자	환자/NNG

육이오	육이오/NNG
때	때/NNG
인민군의	인민군/NNG+의/JKG
포격으로	포격/NNG+으로/JKB
부상을	부상/NNG+을/JKO
입은	입/VV+은/ETM
그녀는	그녀/NP+는/JX
외상성	외상성/NNG
뇌손상으로	뇌손상/NNG+으로/JKB
인한	인하/VV+ㄴ/ETM
실어증과	실어증/NNG+과/JC
기억장애에	기억장애/NNG+에/JKB
걸렸다	걸리/VV+었/EP+다/EC

십년	십/NR+년/NNB
전,	전/NNG+,/SP
치매환자	치매환자/NNG
수용소에서	수용소/NNG+에서/JKB
자원봉사를	자원봉사/NNG+를/JKO
온	오/VV+ㄴ/ETM
명주와	명주/NNP+와/JC
재회했다	재회하/VV+였/EP+다/EC

’1960년에	’/SL+1960/SN+년/NNB+에/JKB
명주가	명주/NNG+가/JKS
수용소에	수용소/NNG+에/JKB
자원봉사를	자원봉사/NNG+를/JKO
나와서	나오/VV+아서/EC
어머니를	어머니/NNG+를/JKO
만날	만나/VV+ㄹ/ETM
수는	수/NNB+는/JX
있을	있/VA+을/ETM
것이다	것/NNB+이/VCP+다/EC

명주는	명주/NNP+는/JX
6	6/SN

25	25/SN
때	때/NNG
잃어버린	잃어버리/VV+ㄴ/ETM
어머니를	어머니/NNG+를/JKO
찾아서	찾/VV+아서/EC
수용소마다	수용소/NNG+마다/JX
뒤지고	뒤지/VV+고/EC
다닐	다니/VV+ㄹ/ETM
수는	수/NNB+는/JX
있었을	있/VA+었/EP+을/ETM
테니까	터/NNB+니/VCN+까/EC

그러나	그러나/MAJ
명주는	명주/NNP+는/JX
어머니를	어머니/NNG+를/JKO
서울	서울/NNP
근교의	근교/NNG+의/JKG
치매전문병원에	치매전문병원/NNG+에/JKB
입원을	입원/NNG+을/JKO
시켜	시키/VV+어/EC
놓고	놓/VX+고/EC
드나들고	드나들/VV+고/EC
있다	있/VX+다/EC

명주는	명주/NNP+는/JX
어머니	어머니/NNG
병문안을	병문안/NNG+을/JKO
가면서	가/VV+면서/EC
다른	다른/MM
사람들에게는	사람/NNG+들/XSN+에게/JKB+는/JX
자원봉사를	자원봉사/NNG+를/JKO
간다고	가/VV+ㄴ다고/EC
했다	하/VV+였/EP+다/EC

아들	아들/NNG
박노경(오창석	박노경/NNP+(/SS+오창석/NNP
분),	분/NNG+)/SS+,/SP
색오름공방의	색오름공방/NNG+의/JKG
김양,	김/NNP+양/NNB+,/SP
방곱단	방곱/NNG+단/XSN
등은	등/NNB+은/JX
‘공방이	‘/SL+공방/NNG+이/JKS
이렇게	이렇/VA+게/EC
바쁜데	바쁘/VA+ㄴ데/EC
요양원에	요양원/NNG+에/JKB
자원봉사하러	자원/NNG+봉사하/VV+러/EC
가느냐’고	가/VX+느냐/EC+’/SN+고/NNG
타박을	타박/NNG+을/JKO
했다	하/VV+였/EP+다/EF

그런데	그런데/MAJ
1960년대에는	1960/SN+년대/NNB+에/JKB+는/JX
치매전문병원도	치매전문병원/NNG+도/JX
없었고	없/VA+었/EP+고/EC
‘자원봉사자’라는	‘/SN+자원봉사자’/NNG+이/VCP+라는/ETM
용어도	용어/NNG+도/JX
없었다	없/VA+었/EP+다/EF

[의료법]에	[/SS+의료법/NNG+]/SS+에/JKB
요양병원이	요양병원/NNG+이/JKS
처음	처음/NNG
생긴	생기/VV+ㄴ/ETM
것은	것/NNB+은/JX
1994년이다	1994/SN+년/NNB+이/VCP+다/EC

필자도	필자/NNG+도/JX
‘사랑아	‘/SN+사랑아/NNG
사랑아’에서	사랑아’/NNG+에서/JKB
처음	처음/NNG
‘자원봉사자’라는	‘/SN+자원봉사자’/NNG+이/VCP+라는/ETM
말을	말/NNG+을/JKO
듣고는	듣/VV+고는/EC
‘저	‘/SN+저/JKB
때는	때/NNG+는/JX
저런	저런/MM
말이	말/NNG+이/JKS
없었는데	없/VA+었/EP+는데/EC

’	’/SL
하고는	하고/JKB+는/JX
그냥	그냥/MAG
지나쳤었다	지나치/VA+었었/EP+다/EF

그런데	그런데/MAJ
‘사랑아	‘/SL+사랑아/NNG
사랑아’는	사랑아/NNG+’/SL+는/JX
지난	지나/VV+ㄴ/ETM
5월	5/SN+월/NNB
7일에	7/SN+일/NNB+에/JKB
시작해서	시작하/VV+여서/EC
아직도	아직/MAG+도/JX
계속하고	계속하/VV+고/EC
있는데	있/VX+는데/EC
엉터리가	엉터리/NNG+가/JKC
하도	하/NNG+도/JX
많아서	많/VA+아서/EC
다시	다시/MAG
한	한/MM
번	번/NNB
‘자원봉사자’를	‘/SN+자원봉사자’/NNG+를/JKO
찾아보게	찾아보/VV+게/EC
되었다	되/VV+었/EP+다/EC

'식모'	'/SS+식/NNP+모/NP+'/SS
ⓒ네이버	ⓒ/SL+네이버/NNP
뉴스	뉴스/NNG
라이브러리	라이브러리/NNG
'버스차장'	'/SS+버스차장/NNG+'/SS
ⓒ네이버	ⓒ/SL+네이버/NNP
뉴스	뉴스/NNG
라이브러리	라이브러리/NNG
시청자	시청자/NNG
게시판을	게시판/NNG+을/JKO
훑어보니	훑어보/VV+니/EC
필자의	필자/NNG+의/JKG
생각과	생각/NNG+과/JKB
비슷한	비슷하/VA+ㄴ/ETM
내용들이	내용/NNG+들/XSN+이/JKS
많았다	많/VA+았/EP+다/EC

최00님은	최/NNP+00/SN+님/NNG+은/JX
예전에	예전/NNG+에/JKB
들은	듣/VV+은/ETM
습작기초	습작기/NNG+초/NNB
강의에서	강의/NNG+에서/JKB
교수는	교수/NNG+는/JX
‘독자를	‘/SL+독자/NNG+를/JKO
우습게보지	우습/VA+게/EC+보/VX+지/EC
말라’고	말/VX+라/EC+’/VV+고/EC
했다는	하/VV+였/EP+다는/ETM
것이다	것/NNB+이/VCP+다/EC

예를	예/NNG+를/JKO
들면	들/VV+면/EC
타이타닉	타이타닉/NNP
침몰	침몰/NNG
전에	전/NNG+에/JKB
한	하/VV+ㄴ/ETM
쌍의	쌍/NNG+의/JKG
로맨틱남녀가	로맨틱남녀/NNG+가/JKS
보름달빛아래서	보름달빛아래/NNG+서/JKB
사랑의	사랑/NNG+의/JKG
포옹을	포옹/NNG+을/JKO
한다는	하/VV+ㄴ다는/ETM
설정을	설정/NNG+을/JKO
한다면,	하/VV+ㄴ다면/EC+,/SP
작가는	작가/NNG+는/JX
필수적으로	필수적/NNG+으로/JKB
당시	당시/NNG
타이타닉	타이타닉/NNP
침몰	침몰/NNG
당일의	당일/NNG+의/JKG
월력과	월력/NNG+과/JC
날씨를	날씨/NNG+를/JKO
확인해야	확인하/VV+여야/EC
한다는	하/VX+ㄴ다는/ETM
것이다	것/NNB+이/VCP+다/EC

참고로	참고/NNG+로/JKB
당일	당일/NNG
밤은	밤/NNG+은/JX
그믐에	그믐/NNG+에/JKB
흐린	흐리/VA+ㄴ/ETM
날씨였다고	날씨/NNG+이/VCP+었/EP+다고/EC
한다	하/VV+ㄴ다/EF

1970년도를	1970/SN+년/NNB+도/NNG+를/JKO
설정으로	설정/NNG+으로/JKB
하는	하/VV+는/ETM
드라마에서	드라마/NNG+에서/JKB
삼륜딸딸이	삼륜딸딸/NNG+이/JKS
운송차로	운송차/NNG+로/JKB
구미에서	구미/NNP+에서/JKB
서울까지	서울/NNP+까지/JX
운행이	운행/NNG+이/JKS
가능하다고	가능하/VA+다고/EC
보시는지?	보/VV+시/EP+는지/EF+?/SF
다미울이라는	다미울/NNG+이/VCP+라는/ETM
구미를	구미/NNG+를/JKO
읍내로	읍내/NNG+로/JKB
둔	두/VV+ㄴ/ETM
깡촌마을에서	깡촌마을/NNG+에서/JKB
서울이	서울/NNP+이/JKS
당일	당일/NNG
생활권이라고	생활권/NNG+이/VCP+라고/EC
생각하시는지?	생각하/VV+시/EP+는지/EF+?/SF
딸이	딸/NNG+이/JKS
아버지	아버지/NNG
첫사랑의	첫사랑/NNG+의/JKG
과거를	과거/NNG+를/JKO
가지고	가지/VV+고/EC
거래를	거래/NNG+를/JKO
한다는	하/VV+ㄴ다는/ETM
황당한	황당하/VA+ㄴ/ETM
막장개념은	막장개념/NNG+은/JX
말도	말/NNG+도/JX
안	안/MAG
되는	되/VV+는/ETM
설정이라는	설정/NNG+이/VCP+라는/ETM
것이다	것/NNB+이/VCP+다/EC

이00님은	이/MM+00/SN+님/NNG+은/JX
시대에	시대/NNG+에/JKB
맞지	맞/VV+지/EC
않은	않/VX+은/ETM
소품이나	소품/NNG+이나/JC
용어를	용어/NNG+를/JKO
지적하기도	지적하/VV+기/ETN+도/JX
했다	하/VX+였/EP+다/EF

당시에는	당시/NNG+에/JKB+는/JX
철필	철필/VV
쓴	쓰/VV+ㄴ/ETM
등사물로	등사물/NNG+로/JKB
인쇄하고	인쇄하/VV+고/EC
종이는	종이/NNG+는/JX
16절지였는데	16/SN+절지/NNG+이/VCP+었/EP+는데/EC
가정통신문이	가정통신문/NNG+이/JKS
컴퓨터로	컴퓨터/NNG+로/JKB
뽑은	뽑/VV+은/ETM
A4였다	A/SL+4/SN+이/VCP+었/EP+다/EF

또	또/MAG
그	그/MM
시대에	시대/NNG+에/JKB
아르바이트라는	아르바이트/NNG+이/VCP+라는/ETM
용어와	용어/NNG+와/JC
서울에	서울/NNP+에/JKB
그렇게	그렇/VA+게/EC
높은	높/VA+은/ETM
빌딩이	빌딩/NNG+이/JKS
있었는지를	있/VA+었/EP+는지/EC+를/JKO
물었다	묻/VV+었/EP+다/EF

언니	언니/NNG
승희는	승희/NNP+는/JX
공부를	공부/NNG+를/JKO
잘해서	잘하/VV+여서/EC
한국대(서울대학?)	한국/NNP+대/NNB+(/SS+서울대학/NNP+?/SF+)/SS
합격을	합격/NNG+을/JKO
했다	하/VV+였/EP+다/EC

승아는	승아/NNP+는/JX
아버지	아버지/NNG
윤식이	윤식이/NNP
녹용을	녹용/NNG+을/JKO
사오라며	살오라/VV+며/EC
만원을	만/NR+원/NNB+을/JKO
주셨는데	주/VV+시었/EP+는데/EC
몇	몇/MM
천	천/NR
원짜리	원/NNB+짜리/XSN
가짜	가짜/NNG
녹용을	녹용/NNG+을/JKO
사오는	사/VV+아/EC+오/VV+는/ETM
바람에	바람/NNB+에/JKB
만복당은	만복당/NNP+은/JX
영업정지를	영업정지/NNG+를/JKO
맞아	맞/VV+아/EC
승희의	승희/NNP+의/JKG
등록금을	등록금/NNG+을/JKO
마련하지	마련하/VV+지/EC
못했다	못하/VX+였/EP+다/EC

윤식은	윤식/NNG+은/JX
사채를	사채/NNG+를/JKO
얻으러	얻/VV+으러/EC
다녔으나,	다니/VV+었/EP+으나/EC+,/SP
양자는	양자/NNG+는/JX
고향	고향/NNG
선배인	선배/NNG+이/VCP+ㄴ/ETM
소망병원	소망병원/NNP
여삼추(김규철	여삼추/NNG+(/SS+김규철/NNP
분)	분/NNG+)/SS
원장한테	원장/NNG+한테/JKB
등록금을	등록금/NNG+을/JKO
빌려	빌리/VV+어/EC
승희에게	승희/NNP+에게/JKB
주었는데	주/VV+었/EP+는데/EC
가수를	가수/NNG+를/JKO
꿈꾸는	꿈꾸/VV+는/ETM
승아가	승아/NNG+가/JKS
그	그/MM
돈을	돈/NNG+을/JKO
훔쳐서	훔치/VV+어서/EC
달아났다	달아나/VV+았/EP+다/EC

아무리	아무리/MAG
시골	시골/NNG
한약방이라고	한약방/NNG+이/VCP+라고/EC
해도	하/VV+여도/EC
딸의	딸/NNG+의/JKG
등록금도	등록금/NNG+도/JX
마련하지	마련하/VV+지/EC
못	못하/VX
할	하/VX+ㄹ/ETM
정도로	정도/NNG+로/JKB
가난했을까	가난하/VA+었/EP+을까/EC

만복당	만복당/NNP
원장은	원장/NNG+은/JX
시골에서	시골/NNG+에서/JKB
대학등록금도	대학등록금/NNG+도/JX
융통하지	융통하/VV+지/EC
못	못/VX
할	하/VX+ㄹ/ETM
정도로	정도/NNG+로/JKB
인심을	인심/NNG+을/JKO
잃었을까	잃/VV+었/EP+을까/EC

소망병원	소망병원/NNP
여삼추	여삼추/NNG
원장은	원장/NNG+은/JX
대학등록금	대학등록금/NNG
정도의	정도/NNG+의/JKG
여유도	여유/NNG+도/JX
없어서	없/VA+어서/EC
등록금	등록금/NNG
몇	몇/MM
만원을	만/NR+원/NNB+을/JKO
은행융자를	은행융자/NNG+를/JKO
받았는가	받/VV+았/EP+는가/EC

김00님은	김/NNP+00/SN+님/NNB+은/JX
1972년도	1972/SN+년도/NNB
서울대	서울대/NNP
인문,	인문/NNG+,/SP
사회계열	사회계열/NNG
등록금이	등록금/NNG+이/JKS
3만2천7백	3/SN+만/NR+2/SN+천/NR+7/SN+백/NR
원이었다고	원/NNB+이/VCP+었/EP+다고/EC
했다	하/VV+였/EP+다/EC

당시의	당시/NNG+의/JKG
서울대	서울대/NNP
등록금이	등록금/NNG+이/JKS
3만원~4만원	3/SN+만/NR+원/NNB+~/SO+4/SN+만/NR+원/NNB
정도(지금	정도/NNG+(/SS+지금/MAG
돈으로	돈/NNG+으로/JKB
300~400만원)인데	300/SN+~/SO+400/SN+만/NR+원/NNB+)/SS+인데/NNG
사기꾼	사기꾼/NNG
김춘봉이	김춘봉/NNP+이/JKS
음반취입	음반취입/NNG
명목으로	명목/NNG+으로/JKB
승아에게	승아/NNG+에게/JKB
제시한	제시하/VV+ㄴ/ETM
돈은	돈/NNG+은/JX
15만원(지금	15/SN+만/NR+원/NNB+(/SS+지금/MAG
돈으로	돈/NNG+으로/JKB
1500만원)이다	1500/SN+만/NR+원/NNB+)/SS+이/VCP+다/EC

승아가	승아/NNG+가/JKS
승희의	승희/NNP+의/JKG
등록금을	등록금/NNG+을/JKO
훔쳐서	훔치/VV+어서/EC
음반취입	음반취입/NNG
명목으로	명목/NNG+으로/JKB
김춘봉한테	김춘봉/NNP+한테/JKB
갖다	갖/VV+다/EC
준	주/VX+ㄴ/ETM
돈은	돈/NNG+은/JX
15만원인데,	15/SN+만/NR+원/NNB+이/VCP+ㄴ데/EC+,/SP
작가는	작가/NNG+는/JX
당시의	당시/NNG+의/JKG
등록금을	등록금/NNG+을/JKO
15만원으로	15/SN+만/NR+원/NNB+으로/JKB
착각한	착각하/VV+ㄴ/ETM
것일까	것/NNB+이/VCP+ㄹ까/EF

의료법(시행	의료법/NNG+(/SS+시행/NNG
1965	1965/SN

5	5/SN

24	24/SN

)	)/SS
ⓒ국가법령정보센터	ⓒ/SL+국가법령정보센터/NNG
의료법(시행	의료법/NNG+(/SS+시행/NNG
2012	2012/SN

9	9/SN

1	1/SN

)	)/SS
ⓒ국가법령정보센터	ⓒ/SL+국가법령정보센터/NNG
결국	결국/NNG
승아의	승아/NNP+의/JKG
음반취입은	음반취입/NNG+은/JX
물	물/NNG
건너갔다	건너가/VV+았/EP+다/EC

승아에게	승아/NNG+에게/JKB
음반취입	음반취입/NNG
명목으로	명목/NNG+으로/JKB
돈을	돈/NNG+을/JKO
뜯어간	뜯/VV+어/EC+가/VX+ㄴ/ETM
김춘봉은	김춘봉/NNP+은/JX
사기꾼이었던	사기꾼/NNG+이/VCP+었/EP+던/ETM
것이다	것/NNB+이/VCP+다/EC

하는	하/VV+는/ETM
수	수/NNB
없이	없이/MAG
승아는	승아/NNP+는/JX
버스안내양을	버스안내양/NNG+을/JKO
했다	하/VV+였/EP+다/EF

소망병원	소망병원/NNP
여삼추	여삼추/NNG
원장은	원장/NNG+은/JX
오래전에	오래전/NNG+에/JKB
상처를	상처/NNG+를/JKO
하고	하/VV+고/EC
중학생	중학생/NNG
딸	딸/NNG
의주를	의주/NNG+를/JKO
키우는데	키우/VV+는/ETM+데/NNB
그	그/MM
집	집/NNG
살림을	살림/NNG+을/JKO
맡아서	맡/VV+아서/EC
딸을	딸/NNG+을/JKO
키우는	키우/VV+는/ETM
사람은	사람/NNG+은/JX
식모	식모/NNG
김말년(김보미	김말년/NNP+(/SS+김보미/NNP
분)이었다	분/NNG+)/SS+이/VCP+었/EP+다/EF

필자는	필자/NNG+는/JX
장애인복지를	장애인복지/NNG+를/JKO
하는	하/VV+는/ETM
사람이다	사람/NNG+이/VCP+다/EC

그러나	그러나/MAJ
1981년	1981/SN+년/NNB
‘심신장애자복지법’이	‘/SN+심신장애자복지법/NNG+’/SL+이/JKS
제정되기	제정되/VV+기/ETN
전까지는	전/NNG+까지는/JX
장애인(장애자)라는	장애인/NNG+(/SS+장애자/NNG+)/SS+이/VCP+라는/ETM
말도	말/NNG+도/JX
없었다	없/VA+었/EP+다/EF

비하용어라고	비하용어/NNG+이/VCP+라고/EC
해서	하/VV+여서/EC
식모는	식모/NNG+는/JX
가정부가	가정부/NNG+가/JKC
되었다가	되/VV+었/EP+다가/EC
요즘은	요즘/NNG+은/JX
가사도우미로	가사도우미/NNG+로/JKB
불리고,	불리/VV+고/EC+,/SP
버스차장도	버스차장/NNG+도/JX
나중에는	나중/NNG+에/JKB+는/JX
버스안내양이	버스안내양/NNG+이/JKC
되었다가	되/VV+었/EP+다가/EC
지금은	지금/NNG+은/JX
안내양도	안내양/NNG+도/JX
없어진지	없어지/VV+ㄴ/ETM+지/NNB
오래다	오래다/MAG

1970년에	1970/SN+년/NNB+에/JKB
김말년이	김말년/NNG+이/JKS
식모로	식모/NNG+로/JKB
불린다면,	불리/VV+ㄴ다면/EC+,/SP
당연히	당연히/MAG
승아도	승/VV+아도/EC
버스차장이라고	버스차장/NNG+이/VCP+라고/EC
불러야	부르/VV+어야/EC
한다	하/VX+ㄴ다/EF

김말년은	김말/NNP+년/NNB+은/JX
식모라고	식모/NNG+이/VCP+라고/EC
하고	하/VV+고/EC
홍승아는	홍승아/NNP+는/JX
버스안내양이라고	버스안내양/NNG+이/VCP+라고/EC
하니	하/VV+니/EC
이것도	이것/NP+도/JX
앞뒤가	앞뒤/NNG+가/JKS
맞지	맞/VV+지/EC
않는다	않/VX+는다/EF

자원봉사자는	자원봉사자/NNG+는/JX
1970년대에는	1970/SN+년대/NNB+에/JKB+는/JX
없었지만	없/VA+었/EP+지만/EC
지금은	지금/NNG+은/JX
거의	거의/MAG
일반화	일반화/NNG
되어	되/VV+어/EC
있다	있/VX+다/EC

그때는	그때/NNG+는/JX
물론이고	물론/MAG+이/VCP+고/EC
지금도	지금/NNG+도/JX
사용하지	사용하/VV+지/EC
않는	않/VX+는/ETM
용어로	용어/NNG+로/JKB
‘소망병원’이	‘소망병원’/NNG+이/JKS
있다	있/VA+다/EF

소망병원은	소망병원/NNP+은/JX
여삼추	여삼추/NNG
원장이	원장/NNG+이/JKS
운영하는	운영하/VV+는/ETM
개인병원인데	개인병원/NNG+이/VCP+ㄴ데/EC
개인병원은	개인병원/NNG+은/JX
예전이나	예전/NNG+이나/JC
지금이나	지금/NNG+이나/JC
병원이라고	병원/NNG+이/VCP+라고/EC
하지	하/VV+지/EC
않고	않/VX+고/EC
의원이라고	의원/NNG+이/VCP+라고/EC
하기	하/VV+기/ETN
때문이다	때문/NNB+이/VCP+다/EC

1970년대	1970/SN+년대/NNB
[의료법]에서나	[/SS+의료법/NNG+]/SS+에서/JKB+나/JX
현행	현행/NNG
[의료법]에서나	[/SS+의료법/NNG+]/SS+에서/JKB+나/JX
의료기관은	의료기관/NNG+은/JX
의원과	의원/NNG+과/JC
병원	병원/NNG
등으로	등/NNB+으로/JKB
나뉘고	나뉘/VV+고/EC
있는데	있/VX+는데/EC
최근에	최근/NNG+에/JKB
와서	오/VV+아서/EC
조산원과	조산원/NNG+과/JC
요양병원	요양병원/NNG
등이	등/NNB+이/JKS
추가되기는	추가되/VV+기/ETN+는/JX
했으나	하/VX+였/EP+으나/EC
개인병원이면	개인병원/NNG+이/VCP+면/EC
여전히	여전히/MAG
의원이고,	의원/NNG+이/VCP+고/EC+,/SP
30인	30/SN+인/NNG
이상의	이상/NNG+의/JKG
입원실이	입원실/NNG+이/JKS
있으면	있/VA+으면/EC
병원이고,	병원/NNG+이/VCP+고/EC+,/SP
100병상	100/SN+병상/NNG
이상이면	이상/NNG+이/VCP+면/EC
종합병원이라고	종합병원/NNG+이/VCP+라고/EC
하는데	하/VV+는데/EC
7개과	7/SN+개/NNB+과/JKB
이상이	이상/NNG+이/JKS
있어야	있/VA+어야/EC
되고,	되/VV+고/EC+,/SP
300병상	300/SN+병상/NNG
이상이	이상/NNG+이/JKC
되면	되/VV+면/EC
9개	9/SN+개/NNB
이상의	이상/NNG+의/JKG
진료과목을	진료과목/NNG+을/JKO
갖추고	갖추/VV+고/EC
각	각/MM
진료과목마다	진료과목/NNG+마다/JX
전속하는	전속하/VV+는/ETM
전문의를	전문의/NNG+를/JKO
두어야	두/VV+어야/EC
한다	하/VX+ㄴ다/EF

‘사랑아	‘/SL+사랑아/NNG
사랑아’	사랑아/NNG+’/SL
여삼추와	여삼추/NNG+와/JC
김말년	김말년/NNP

ⓒKBS	ⓒKBS/SL
그리고	그리고/MAJ
제사란	제사/NNG+란/JX
네이버	네/MM+이버/NNB
국어사전에	국어사전/NNG+에/JKB
의하면	의하/VV+면/EC
‘신령이나	‘/SL+신령/NNG+이나/JC
죽은	죽/VV+은/ETM
사람의	사람/NNG+의/JKG
넋에게	넋/NNG+에게/JKB
음식을	음식/NNG+을/JKO
바치어	바치/VV+어/EC
정성을	정성/NNG+을/JKO
나타냄	나타내/VV+ㅁ/ETN

또는	또는/MAG
그런	그런/MM
의식	의식/NNG

’이라고	’/SL+이/VCP+라고/EC
나와	나오/VV+아/EC
있다	있/VX+다/EC

명절마다	명절/NNG+마다/JX
고속도로에서도	고속도로/NNG+에서/JKB+도/JX
느림보	느림보/NNG
운행을	운행/NNG+을/JKO
해도	하/VV+여도/EC
고향으로	고향/NNG+으로/JKB
가는	가/VV+는/ETM
큰	크/VA+ㄴ/ETM
이유	이유/NNG
중	중/NNB
하나는	하나/NNG+는/JX
조상들에게	조상/NNG+들/XSN+에게/JKB
차례를	차례/NNG+를/JKO
지내기	지내/VV+기/ETN
위함이	위하/VV+ㅁ/ETN+이/JKC
아닐까	아니/VCN+ㄹ까/EC
싶다	싶/VX+다/EC

이	이/MM
때의	때/NNG+의/JKG
조상이란	조상/NNG+이/VCP+란/ETM
아버지	아버지/NNG
할아버지	할아버지/NNG
등의	등/NNB+의/JKG
직계조상이다	직계조상/NNG+이/VCP+다/EC

‘사랑아	‘/SN+사랑아/NNG
사랑아’에서도	사랑아’/NNG+에서/JKB+도/JX
지난	지나/VV+ㄴ/ETM
추석날	추석날/NNG
아침에	아침/NNG+에/JKB
차례를	차례/NNG+를/JKO
지내는	지내/VV+는/ETM
모습이	모습/NNG+이/JKS
방영되었다	방영되/VV+었/EP+다/EC

윤식이네	윤식이네/NNP
집에서는	집/NNG+에서/JKB+는/JX
당연히	당연히/MAG
윤식이	윤식이/NNP
아버지	아버지/NNG
그리고	그리고/MAJ
할아버지와	할아버지/NNG+와/JC
그	그/MM
윗대	윗대/NNG
조상에	조상/NNG+에/JKB
대한	대하/VV+ㄴ/ETM
차례를	차례/NNG+를/JKO
지냈을	지내/VV+었/EP+을/ETM
것이다	것/NNB+이/VCP+다/EC

그런데	그런데/MAJ
그	그/MM
자리에	자리/NNG+에/JKB
금동	금동/NNP
할배가	할배/NNG+가/JKS
있었으니	있/VA+었/EP+으니/EC
이는	이/NP+는/JX
어떻게	어떻/VA+게/EC
이해해야	이해하/VV+여야/EC
할까	하/VX+ㄹ까/EF

이금동(김효원	이금동/NNP+(/SS+김효원/NNP
분)은	분/NNG+)/SS+은/JX
윤식의	윤식/NNG+의/JKG
어머니	어머니/NNG
이금녀(김여옥	이금녀/NNP+(/SS+김여옥/NNP
분)의	분/NNG+)/SS+의/JKG
동생으로	동생/NNG+으로/JKB
윤식의	윤식/NNG+의/JKG
외삼촌이다	외삼촌/NNG+이/VCP+다/EC

이금녀와	이금녀/NNP+와/JC
이금동에게도	이금동/NNP+에게/JKB+도/JX
그를	그/NP+를/JKO
낳아서	낳/VV+아서/EC
길러	기르/VV+어/EC
준	주/VX+ㄴ/ETM
부모와	부모/NNG+와/JC
할아버지	할아버지/NNG
등	등/NNB
조상이	조상/NNG+이/JKS
있을	있/VA+을/ETM
텐데,	터/NNB+이/VCP+ㄴ데/EC+,/SP
이금동도	이금동/NNP+도/JX
방순이를	방순이/NNG+를/JKO
데리고	데리/VV+고/EC
자기	자기/NP
아버지	아버지/NNG
산소라도	산소/NNG+라도/JX
찾아야지	찾/VV+아야지/EC
왜	왜/MAG
남의	남/NNG+의/JKG
조상	조상/NNG
차례상에	차례상/NNG+에/JKB
얼쩡거리	얼쩡거리/NNG
것일까	것/NNB+이/VCP+ㄹ까/EF

물론	물론/MAG
이름	이름/NNG
모를	모르/VV+ㄹ/ETM
조상에게	조상/NNG+에게/JKB
술	술/NNG
한	한/MM
잔	잔/NNG
바칠	바치/VV+ㄹ/ETM
수도	수/NNB+도/JX
있겠지만	있/VA+겠/EP+지만/EC
이건	이그것/NP+ㄴ/JX
좀	좀/MAG
아니지	아니/VCN+지/EC
않을까	않/VX+을까/EC
싶다	싶/VX+다/EC

‘사랑아	‘/SN+사랑아/NNG
사랑아’는	사랑아’/NNG+는/JX
시청자들이	시청자/NNG+들/XSN+이/JKS
뭐라고	뭐/NP+이/VCP+라고/EC
하건	하/VV+건/EC
말건	말/VV+건/EC
모르쇠로	모르쇠/NNG+로/JKB
일관한	일관하/VV+ㄴ/ETM
채	채/NNB
현실과	현실/NNG+과/JKB
괴리된	괴리되/VV+ㄴ/ETM
이상한	이상하/VA+ㄴ/ETM
세계에서	세계/NNG+에서/JKB
뒤죽박죽되어	뒤죽박죽되/VV+어/EC
이제는	이제/NNG+는/JX
끝을	끝/NNG+을/JKO
향해	향하/VV+여/EC
치닫고	치닫/VV+고/EC
있는데	있/VX+는데/EC
작가와	작가/NNG+와/JC
연출가는	연출가/NNG+는/JX
정말	정말/MAG
시청자를	시청자/NNG+를/JKO
우습게	우습/VA+게/EC
아는	알/VV+는/ETM
모양이다	모양/NNG+이/VCP+다/EC

어차피	어차피/MAG
드라마의	드라마/NNG+의/JKG
마지막은	마지막/NNG+은/JX
권선징악으로	권선징악/NNG+으로/JKB
아름답게	아름답/VA+게/EC
막을	막/NNG+을/JKO
내리겠지만	내리/VV+겠/EP+지만/EC
‘사랑아	‘/SL+사랑아/NNG
사랑아’는	사랑아’/NNG+는/JX
사이코드라마가	사이코드라마/NNG+가/JKS
아니다	아니/VCN+다/EC

그럼에도	그렇/VA+ㅁ에도/EC
다이울에서	다이울/NNG+에서/JKB
나고	나/VV+고/EC
자란	자라/VV+ㄴ/ETM
사람들이	사람/NNG+들/XSN+이/JKS
서울말을	서울말/NNG+을/JKO
사용하고,	사용하/VV+고/EC+,/SP
1970년에는	1970/SN+년/NNB+에/JKB+는/JX
대부분의	대부분/NNG+의/JKG
사람들이	사람/NNG+들/XSN+이/JKS
‘테레비’라고	‘/SN+테레비’/NNG+이/VCP+라고/EC
했는데	하/VV+였/EP+는데/EC
TV라고	TV/SL+이/VCP+라고/EC
하질	하/VV+지/EC+ㄹ/JX
않나,	않/VX+나/EC+,/SP
경어를	경어/NNG+를/JKO
쓴답시고	쓰/VV+ㄴ답시고/EC
전화가	전화/NNG+가/JKS
오시는	오/VV+시/EP+는/ETM
것은	것/NNB+은/JX
정말	정말/MAG
아니올시다	아니/VCN+올시다/EC

*	*/SW
이복남	이복남/NNP
기자는	기자/NNG+는/JX
에이블뉴스	에이블뉴스/NNP
객원기자로	객원기자/NNG+로/JKB
하사가장애인상담넷(www	하사가장애인상담넷/NNG+(/SS+www/SL

gktkrk	gktkrk/SL

net)	net/SL+)/SS
원장으로	원장/NNG+으로/JKB
활동하고	활동하/VV+고/EC
있습니다	있/VX+습니다/EF
