‘제2회	‘/SL+제/XPN+2/SN+회/NNB
직지배	직지배/NNG
전국장애인	전/MM+국장애인/NNG
론볼대회’	론볼대회/NNP+’/SL
개최	개최/NNG

‘제2회	‘/SL+제/XPN+2/SN+회/NNB
직지배	직지배/NNG
전국장애인	전/MM+국장애인/NNG
론볼대회’가	론볼대회/NNP+’/SL+가/JKS
오는	오/VV+는/ETM
18일부터	18/SN+일/NNB+부터/JX
19일까지	19/SN+일/NNB+까지/JX
이틀간	이틀/NNG+간/XSN
충북곰두리체육관	충북곰두리체육관/NNP
론볼경기장에서	론볼/NNP+경기장/NNG+에서/JKB
열린다	열리/VV+ㄴ다/EF

청주시가	청주시/NNP+가/JKS
후원하고	후원하/VV+고/EC
대한장애인론볼연맹과	대한/NNP+장애인론볼연맹/NNG+과/JC
청주시장애인론볼연맹이	청주시/NNP+장애인/NNG+론/XSN+볼연맹/NNG+이/JKS
주관하는	주관하/VV+는/ETM
이번	이번/NNG
대회에는	대회/NNG+에/JKB+는/JX
전국의	전국/NNG+의/JKG
250명	250/SN+명/NNB
론볼	론볼/NNG
동호인들이	동호인/NNG+들/XSN+이/JKS
참가해	참가하/VV+여/EC
열띤	열띠/VA+ㄴ/ETM
경쟁을	경쟁/NNG+을/JKO
펼치게	펼치/VV+게/EC
된다	되/VV+ㄴ다/EF

대회는	대회/NNG+는/JX
18일	18/SN+일/NNB
개회식을	개회식/NNG+을/JKO
시작으로	시작/NNG+으로/JKB
예선	예선/NNG
조별	조별/NNG
리그전이,	리그전/NNG+이/JKS+,/SP
19일에는	19/SN+일/NNB+에/JKB+는/JX
본선	본선/NNG
16강	16/SN+강/NNG
토너먼트	토너먼트/NNG
및	및/MAG
입상자	입상자/NNG
시상식이	시상식/NNG+이/JKS
진행된다	진행되/VV+ㄴ다/EC

이번	이번/NNG
대회	대회/NNG
참가팀들은	참가팀/NNG+들/XSN+은/JX
국제론볼연맹과	국제론볼연맹/NNG+과/JC
대한장애인론볼연맹의	대한/NNP+장애인론볼연맹/NNG+의/JKG
규정에	규정/NNG+에/JKB
따라	따르/VV+아/EC
장애등급과	장애등급/NNG+과/JC
성별	성별/NNG
구분	구분/NNG
없이	없이/MAG
통합	통합/NNG
3인조로	3/SN+인/NNG+조/XSN+로/JKB
구성됐다	구성되/VV+었/EP+다/EF
