장애인	장애인/NNG
법률조력인제	법률조력인/NNG+제/XSN
시행..'도가니	시행/NNG+../SF+'/SS+도가니/NNG
사건'	사건/NNG+'/SS
재발방지	재발방지/NNG

(서울=연합뉴스)	(/SS+서울/NNP+=/SW+연합뉴스/NNP+)/SS
하채림	하채림/NNP
기자	기자/NNG
=	=/SW
정부	정부/NNG
장애인정책조정위원회가	장애인정책조정위원회/NNG+가/JKS
7일	7/SN+일/NNB
마련한	마련하/VV+ㄴ/ETM
제	제/XPN
4차	4/SN+차/NNB
장애인정책종합계획(2013~2017)은	장애인정책종합계획/NNG+(/SS+2013/SN+~/SO+2017/SN+)/SS+은/JX
장애인의	장애인/NNG+의/JKG
건강·소득을	건강/NNG+·/SP+소득/NNG+을/JKO
보장하고	보장하/VV+고/EC
사회	사회/NNG
접근성을	접근성/NNG+을/JKO
확대하는	확대하/VV+는/ETM
등	등/NNB
기존	기존/NNG
정책을	정책/NNG+을/JKO
강화하는	강화하/VV+는/ETM
것이	것/NNB+이/JKS
주요	주요/NNG
내용이다	내용/NNG+이/VCP+다/EC

나아가	나아가/VV+아/EC
그동안	그동안/NNG
미흡하다는	미흡하/VA+다는/ETM
평가를	평가/NNG+를/JKO
받은	받/VV+은/ETM
인권	인권/NNG
대책을	대책/NNG+을/JKO
대폭	대폭/MAG
보완했다	보완하/VV+였/EP+다/EC

이는	이/NP+는/JX
'도가니	'/SS+도가니/NNG
사건'	사건/NNG+'/SS
등을	등/NNB+을/JKO
계기로	계기/NNG+로/JKB
더	더/MAG
이상	이상/NNG
장애인	장애인/NNG
인권유린을	인권유린/NNG+을/JKO
방치해서는	방치하/VV+여서/EC+는/JX
안된다는	안되/VV+ㄴ다는/ETM
사회적	사회적/NNG
공감대가	공감대/NNG+가/JKS
확산됐기	확산되/VV+었/EP+기/ETN
때문으로	때문/NNB+으로/JKB
풀이된다	풀이되/VV+ㄴ다/EF

또	또/MAG
지난	지나/VV+ㄴ/ETM
10월	10/SN+월/NNB
중증장애인	중증장애인/NNG
여성이	여성/NNG+이/JKS
화재로	화재/NNG+로/JKB
안타깝게	안타깝/VA+게/EC
목숨을	목숨/NNG+을/JKO
잃은	잃/VV+은/ETM
이후	이후/NNG
장애계가	장애/NNG+계/XSN+가/JKS
강력하게	강력하/VA+게/EC
요구해온	요구하/VV+여/EC+오/VX+ㄴ/ETM
활동지원	활동지원/NNG
확대도	확대/NNG+도/JX
이번	이번/NNG
4차	4/SN+차/NNB
계획에	계획/NNG+에/JKB
반영됐다	반영되/VV+었/EP+다/EF

◇"장애인정책과제	◇/SW+"/SS+장애인정책과제/NNG
이행	이행/NNG
예산,	예산/NNG+,/SP
5년후	5/SN+년/NNB+후/NNG
2배로"	2/SN+배로/NNG+"/SS
=	=/SW
4차	4/SN+차/NNB
장애인정책종합계획은	장애인정책종합계획/NNG+은/JX
'장애인과	'/SS+장애인/NNG+과/JC
비장애인이	비장애인/NNG+이/JKS
더불아	더불/VV+아/EC
행복한	행복하/VA+ㄴ/ETM
사회'를	사회/NNG+'/SS+를/JKO
비전으로	비전/NNG+으로/JKB
복지·건강	복지/NNG+·/SP+건강/NNG
교육·문화	교육/NNG+·/SP+문화/NNG
경제활동	경제활동/NNG
사회참여·권익증진의	사회참여/NNG+·/SP+권익증진/NNG+의/JKG
4대	4/SN+대/NNB
분야에서	분야/NNG+에서/JKB
71개	71/SN+개/NNB
세부과제를	세부과제/NNG+를/JKO
제시했다	제시하/VV+였/EP+다/EC

이	이/MM
가운데	가운데/NNG
장애인	장애인/NNG
활동지원	활동지원/NNG
확대,	확대/NNG+,/SP
장애인연금	장애인연금/NNG
인상,	인상/NNG+,/SP
특수학급	특수학급/NNG
매년	매년/MAG
500개	500/SN+개/NNB
신설,	신설/NNG+,/SP
장애인	장애인/NNG
의무고용률	의무고용/NNG+률/XSN
상향	상향/NNG
조정,	조정/NNG+,/SP
저상버스	저상버스/NNG
2배	2/SN+배/NNG
이상	이상/NNG
확대는	확대/NNG+는/JX
분야별	분야/NNG+별/XSN
주요	주요/NNG
과제로	과제/NNG+로/JKB
추진된다	추진되/VV+ㄴ다/EF

올해로	올해/NNG+로/JKB
끝나는	끝나/VV+는/ETM
3차	3/SN+차/NNB
종합계획의	종합계획/NNG+의/JKG
58개	58/SN+개/NNB
과제에	과제/NNG+에/JKB
집행된	집행되/VV+ㄴ/ETM
예산은	예산/NNG+은/JX
현재	현재/MAG
연간	연간/NNG
1조9천억원	1/SN+조/NR+9/SN+천억/NR+원/NNB
수준이며,	수준/NNG+이/VCP+며/EC+,/SP
4차	4/SN+차/NNB
계획에서	계획/NNG+에서/JKB
제시한	제시하/VV+ㄴ/ETM
71개	71/SN+개/NNB
세부과제가	세부과제/NNG+가/JKS
목표대로	목표/NNG+대로/JX
이행될	이행되/VV+ㄹ/ETM
경우	경우/NNG
2017년에는	2017/SN+년/NNB+에/JKB+는/JX
올해의	올해/NNG+의/JKG
2배에	2/SN+배/NNG+에/JKB
가까운	가깝/VA+ㄴ/ETM
예산이	예산/NNG+이/JKS
소요될	소요되/VV+ㄹ/ETM
것으로	것/NNB+으로/JKB
복지부는	복지부/NNG+는/JX
전망했다	전망하/VV+였/EP+다/EF

◇내년부터	◇/SW+내년/NNG+부터/JX
법률조력인제	법률조력인/NNG+제/XSN
시행	시행/NNG
=	=/SW
이번	이번/NNG
4차	4/SN+차/NNB
장애인계획에는	장애인계획/NNG+에/JKB+는/JX
장애인	장애인/NNG
인권	인권/NNG
보장을	보장/NNG+을/JKO
위한	위하/VV+ㄴ/ETM
다양한	다양하/VA+ㄴ/ETM
대책들이	대책/NNG+들/XSN+이/JKS
담겼다	담기/VV+었/EP+다/EF

`도가니	`/SW+도가니/NNG
사건'	사건/NNG+'/SS
등으로	등/NNB+으로/JKB
장애인의	장애인/NNG+의/JKG
인권	인권/NNG
침해를	침해/NNG+를/JKO
막아야	막/VV+아야/EC
한다는	하/VX+ㄴ다는/ETM
사회적	사회적/NNG
요구가	요구/NNG+가/JKS
거세졌기	거세지/VV+었/EP+기/ETN
때문으로	때문/NNB+으로/JKB
풀이된다	풀이되/VV+ㄴ다/EF

정부는	정부/NNG+는/JX
장애학생의	장애학생/NNG+의/JKG
인권침해	인권침해/NNG
예방과	예방/NNG+과/JC
대응을	대응/NNG+을/JKO
위해	위하/VV+여/EC
내년부터	내년/NNG+부터/JX
특수교육지원센터에	특수교육지원센터/NNG+에/JKB
상설모니터단을	상설모니터단/NNG+을/JKO
운영하기로	운영하/VV+기/ETN+로/JKB
했다	하/VV+였/EP+다/EC

모니터단은	모니터/NNG+단/XSN+은/JX
분기마다	분기/NNG+마다/JX
한	한/MM
차례	차례/NNG
이상	이상/NNG
일반	일반/NNG
학교와	학교/NNG+와/JC
특수학교를	특수학교/NNG+를/JKO
방문해	방문하/VV+여/EC
장애인	장애인/NNG
인권침해	인권침해/NNG
사례가	사례/NNG+가/JKS
없는지	없/VA+는지/EC
살펴보는	살펴보/VV+는/ETM
역할을	역할/NNG+을/JKO
맡는다	맡/VV+는다/EF

또	또/MAG
모든	모든/MM
학생에게	학생/NNG+에게/JKB
1년에	1/SN+년/NNB+에/JKB
두	두/MM
차례	차례/NNG
장애이해교육,	장애이해교육/NNG+,/SP
장애인권교육,	장애인권교육/NNG+,/SP
장애학생	장애학생/NNG
성폭력	성폭력/NNG
예방교육을	예방교육/NNG+을/JKO
의무적으로	의무적/NNG+으로/JKB
실시할	실시하/VV+ㄹ/ETM
계획이다	계획/NNG+이/VCP+다/EC

중앙에만	중앙/NNG+에/JKB+만/JX
설치된	설치되/VV+ㄴ/ETM
장애인	장애인/NNG
인권침해예방센터는	인권침해예방센터/NNG+는/JX
17개	17/SN+개/NNB
시도로	시도/NNG+로/JKB
확대	확대/NNG
설치하고,	설치하/VV+고/EC+,/SP
아직도	아직/MAG+도/JX
인권침해	인권침해/NNG
논란이	논란/NNG+이/JKS
지속되는	지속되/VV+는/ETM
장애인시설에	장애인시설/NNG+에/JKB
대해	대하/VV+여/EC
인권실태조사도	인권실태조사/NNG+도/JX
실시할	실시하/VV+ㄹ/ETM
방침이다	방침/NNG+이/VCP+다/EC

현재	현재/MAG
아동·청소년	아동/NNG+·/SP+청소년/NNG
성범죄	성범죄/NNG
피해자를	피해자/NNG+를/JKO
대상으로	대상/NNG+으로/JKB
시행	시행/NNG
중인	중/NNB+이/VCP+ㄴ/ETM
법률조력인제도를	법률조력인제도/NNG+를/JKO
내년부터	내년/NNG+부터/JX
장애인	장애인/NNG
여성	여성/NNG
성폭력	성폭력/NNG
피해자로	피해자/NNG+로/JKB
확대하고	확대하/VV+고/EC
이듬해에는	이듬해/NNG+에/JKB+는/JX
진술조력인제도도	진술조력인제도/NNG+도/JX
도입할	도입하/VV+ㄹ/ETM
예정이다	예정/NNG+이/VCP+다/EC

법률조력인은	법률조력인/NNG+은/JX
검사가	검사/NNG+가/JKS
성폭력	성폭력/NNG
피해자를	피해자/NNG+를/JKO
위해	위하/VV+여/EC
특별히	특별히/MAG
지정하는	지정하/VV+는/ETM
국선변호인을	국선변호인/NNG+을/JKO
가리키며	가리키/VV+며/EC
진술조력인은	진술조력인/NNG+은/JX
의사소통이나	의사소통/NNG+이나/JC
표현에	표현/NNG+에/JKB
어려움이	어려움/NNG+이/JKS
있는	있/VA+는/ETM
피해자의	피해자/NNG+의/JKG
진술을	진술/NNG+을/JKO
보조하는	보조하/VV+는/ETM
인력을	인력/NNG+을/JKO
말한다	말하/VV+ㄴ다/EF

◇대규모	◇/SW+대규모/NNG
장애인시설	장애인시설/NNG
점차	점차/MAG
없앤다	없애/VV+ㄴ다/EC
=	=/SW
장애인을	장애인/NNG+을/JKO
시설로	시설/NNG+로/JKB
몰아	몰/VV+아/EC
넣지	넣/VV+지/EC
않고	않/VX+고/EC
지역사회	지역사회/NNG
안에서	안/NNG+에서/JKB
자립할	자립하/VV+ㄹ/ETM
수	수/NNB
있도록	있/VA+도록/EC
돕는	돕/VV+는/ETM
주거	주거/NNG
지원도	지원/NNG+도/JX
확대돼	확대되/VV+어/EC
장애인	장애인/NNG
인권	인권/NNG
신장에	신장/NNG+에/JKB
기여할	기여하/VV+ㄹ/ETM
것으로	것/NNB+으로/JKB
예상된다	예상되/VV+ㄴ다/EF

정부는	정부/NNG+는/JX
장애인시설의	장애인시설/NNG+의/JKG
인권침해	인권침해/NNG
문제를	문제/NNG+를/JKO
근본적으로	근본적/NNG+으로/JKB
해결하기	해결하/VV+기/ETN
위해	위하/VV+여/EC
생활인원	생활인원/NNG
30인이	30/SN+인/NNG+이/JKS
넘는	넘/VV+는/ETM
중ㆍ대규모	중/NNB+ㆍ/SP+대규모/NNG
시설을	시설/NNG+을/JKO
30인	30/SN+인/NNG
이하	이하/NNG
소규모	소규모/NNG
시설로	시설/NNG+로/JKB
단계적으로	단계적/NNG+으로/JKB
전환키로	전환하/VV+기/ETN+로/JKB
방침을	방침/NNG+을/JKO
정했다	정하/VV+였/EP+다/EF

우선	우선/MAG
100인	100/SN+인/NNG
이상	이상/NNG
대규모	대규모/NNG
시설을	시설/NNG+을/JKO
현재	현재/MAG
17	17/SN

8%에서	8/SN+%/SW+에서/JKB
5년	5/SN+년/NNB
후	후/NNG
12	12/SN

2%까지	2/SN+%/SW+까지/JX
줄이는	줄이/VV+는/ETM
목표를	목표/NNG+를/JKO
세웠다	세우/VV+었/EP+다/EC

국민임대주택	국민임대주택/NNG
건설물량의	건설물량/NNG+의/JKG
5%는	5/SN+%/SW+는/JX
장애인에게	장애인/NNG+에게/JKB
우선	우선/MAG
돌아가고,	돌아가/VV+고/EC+,/SP
국민주택기금으로	국민주택기금/NNG+으로/JKB
장애인	장애인/NNG
가구의	가구/NNG+의/JKG
주택	주택/NNG
자금을	자금/NNG+을/JKO
지원할	지원하/VV+ㄹ/ETM
때	때/NNG
우대금리를	우대금리/NNG+를/JKO
제공한다	제공하/VV+ㄴ다/EF

주택자금	주택자금/NNG
규모는	규모/NNG+는/JX
내년	내년/NNG
854억원에서	854/SN+억/NR+원/NNB+에서/JKB
2017년	2017/SN+년/NNB
1천50억원으로	1/SN+천/NR+50/SN+억/NR+원/NNB+으로/JKB
늘어나고,	늘어나/VV+고/EC+,/SP
장애인에	장애인/NNG+에/JKB
게	것/NNB+이/JKS
적합하도록	적합하/VA+도록/EC
주택	주택/NNG
개보수를	개보수/NNG+를/JKO
지원하는	지원하/VV+는/ETM
개조비	개조비/NNG
지원	지원/NNG
가구수도	가구수/NNG+도/JX
1천가구에서	1/SN+천/NR+가구/NNG+에서/JKB
2천가구로	2/SN+천/NR+가구/NNG+로/JKB
확대된다	확대되/VV+ㄴ다/EF

tree@yna	tree/SL+@/SW+yna/SL

co	co/SL

kr<저	kr/SL+</SS+저/MM
작	작/NNG
권	권/NNP
자(c)연	자/NP+(/SS+c/SL+)/SS+연/NNG
합	합/NNG
뉴	뉴/NNG
스	스/NNG

무	무/NNG
단	단/MM
전	전/NNG
재-재	재/NNG+-/SO+재/NNG
배	배/NNG
포	포/NNG
금	금/VV
지	짓/VV

>	>/SS
