유엔에스캅	유엔에스캅/NNP
고위급회의	고위급회/NNG+의/JKG
‘이목’	‘/SL+이목/NNG+’/SL
집중	집중/NNG

보건복지부(장관	보건복지부/NNG+(/SS+장관/NNG
임채민)와	임채민/NNG+)/SS+와/JC
유엔에스캅이	유엔에스캅/NNP+이/JKS
주최하는	주최하/VV+는/ETM
‘유엔에스캅	‘/SL+유엔/NNP+에스캅/NNG
정부간고위급회의(ESCAP	정부간고위급회의/NNG+(/SS+ESCAP/SL
High-level	High/SL+-/SO+level/SL
Intergovernmental	Intergovernmental/SL
Meeting)’가	Meeting/SL+)/SS+’/SL+가/JKS
오는	오/VV+는/ETM
29일	29/SN+일/NNB
인천	인천/NNP
송도컨벤시아에서	송도컨벤시아/NNP+에서/JKB
개막한다	개막하/VV+ㄴ다/EF

‘아시아태평양	‘/SN+아시아태평양/NNP
장애인의	장애인/NNG+의/JKG
권리	권리/NNG
실현’을	실현’/NNG+을/JKO
주제로	주제/NNG+로/JKB
열리는	열리/VV+는/ETM
‘유엔에스캅	‘/SL+유엔에스캅/NNP
정부간고위급회의’는	정부간고위급회의’/NNG+는/JX
제2차	제/XPN+2/SN+차/NNB
아태장애인	아태장애/NNG+이/VCP+ㄴ/ETM
10년을	10/SN+년/NNB+을/JKO
평가하고,	평가하/VV+고/EC+,/SP
다가오는	다가오/VV+는/ETM
제3차	제/XPN+3/SN+차/NNB
아태장애인	아태장애인/NNG
10년을	10/SN+년/NNB+을/JKO
위한	위하/VV+ㄴ/ETM
인천전략을	인천/NNP+전략/NNG+을/JKO
수립하기	수립하/VV+기/ETN
위한	위하/VV+ㄴ/ETM
자리다	자리/NNG+이/VCP+다/EF

이번	이번/NNG
회의는	회의/NNG+는/JX
고위급	고위급/NNG
회의와	회의/NNG+와/JC
장관급	장관급/NNG
회의로	회의/NNG+로/JKB
나눠지며,	나누/VV+어/EC+지/VX+며/EC+,/SP
29일부터	29/SN+일/NNB+부터/JX
31일까지	31/SN+일/NNB+까지/JX
3일	3/SN+일/NNB
동안	동안/NNG
열리는	열리/VV+는/ETM
‘고위급회의’에서는	‘/SN+고위급회의’/NNG+에서/JKB+는/JX
제2차	제/XPN+2/SN+차/NNB
아태장애인	아태장애/NNG+이/VCP+ㄴ/ETM
10년에	10/SN+년/NNB+에/JKB
대한	대하/VV+ㄴ/ETM
평가와	평가/NNG+와/JC
향후	향후/NNG
10년간	10/SN+년/NNB+간/XSN
아시아태평양	아시아태평양/NNP
국가들이	국가/NNG+들/XSN+이/JKS
추진할	추진하/VV+ㄹ/ETM
전략에	전략/NNG+에/JKB
대한	대하/VV+ㄴ/ETM
검토가	검토/NNG+가/JKS
진행된다	진행되/VV+ㄴ다/EC

이어	이어/MAG
11월	11/SN+월/NNB
1일부터	1/SN+일/NNB+부터/JX
2일까지	2/SN+일/NNB+까지/JX
열리는	열리/VV+는/ETM
‘장관급회의’에서는	‘/SN+장관급회의’/NNG+에서/JKB+는/JX
에스캅	에스캅/NNG
회원국의	회원국/NNG+의/JKG
각료급	각료급/NNG
대표단이	대표단/NNG+이/JKS
참석,	참석/NNG+,/SP
인천전략	인천/NNP+전략/NNG
실행을	실행/NNG+을/JKO
위한	위하/VV+ㄴ/ETM
국가별	국가/NNG+별/XSN
발언이	발언/NNG+이/JKS
진행된	진행되/VV+ㄴ/ETM
후	후/NNG
인천전략이	인천/NNP+전략/NNG+이/JKS
최종	최종/NNG
선포된다	선포되/VV+ㄴ다/EF

제3차	제/XPN+3/SN+차/NNB
아태장애인	아태장애인/NNG
10년(인천전략)에는	10/SN+년/NNB+(/SS+인천전략/NNG+)/SS+에/JKB+는/JX
장애인	장애인/NNG
빈곤감소	빈곤감소/NNG
IT를	IT/SL+를/JKO
활용한	활용하/VV+ㄴ/ETM
접근성	접근성/NNG
확보	확보/NNG
장애인의	장애인/NNG+의/JKG
사회참여	사회참여/NNG
확대	확대/NNG
등	등/NNB
다양한	다양하/VA+ㄴ/ETM
분야에서의	분야/NNG+에서/JKB+의/JKG
장애인	장애인/NNG
권리	권리/NNG
실현	실현/NNG
방안이	방안/NNG+이/JKS
담길	담기/VV+ㄹ/ETM
예정이다	예정/NNG+이/VCP+다/EC

한편	한편/MAG
유엔에스캅	유엔에스캅/NNP
정부간고위급회의의	정부간고위급회의/NNG+의/JKG
개막식에는	개막식/NNG+에/JKB+는/JX
유엔	유엔/NNP
에스캅	에스캅/NNG
회원·준회원국	회원/NNG+·/SP+준/XPN+회원국/NNG
37개국에서	37/SN+개국/NNB+에서/JKB
180여명의	180/SN+여/XSN+명/NNB+의/JKG
정부대표단과	정부대표단/NNG+과/JKB
아태지역	아태/NNP+지역/NNG
국내·외	국내/NNG+·/SP+외/NNB
시민사회단체	시민사회단체/NNG
대표	대표/NNG
등	등/NNB
370여명이	370/SN+여/XSN+명/NNB+이/JKS
참석한다	참석하/VV+ㄴ다/EF
