안철수	안철수/NNP
기자회견,	기자회견/NNG+,/SP
수화통역사	수화통역사/NNG
배치	배치/NNG
‘환영’	‘/SN+환영’/NNG

한국농아인협회가	한국농아인협회/NNP+가/JKS
지난	지나/VV+ㄴ/ETM
19일	19/SN+일/NNB
안철수	안철수/NNP
서울대	서울대/NNP
융합과학기술대학원장의	융합과학기술대학원장/NNG+의/JKG
대선출마	대선출마/NNG
기자회견	기자회견/NNG
당시	당시/NNG
수화통역사가	수화통역사/NNG+가/JKS
배치된	배치되/VV+ㄴ/ETM
것에	것/NNB+에/JKB
대해	대하/VV+여/EC
환영의	환영/NNG+의/JKG
뜻을	뜻/NNG+을/JKO
밝혔다	밝히/VV+었/EP+다/EC

서울	서울/NNP
충정로	충정로/NNP
구세군	구세군/NNG
아트홀에서	아트홀/NNG+에서/JKB
열린	열리/VV+ㄴ/ETM
안철수	안철수/NNP
서울대	서울대/NNP
융합과학기술대학원장의	융합과학기술대학원장/NNG+의/JKG
대선출마	대선출마/NNG
기자회견에는	기자회견/NNG+에/JKB+는/JX
서울농아인협회	서울농아인협회/NNP
소속	소속/NNG
이민언	이민언/NNP
수화통역사가	수화통역사/NNG+가/JKS
배석해	배석하/VV+여/EC
청각장애인들을	청각장애인/NNG+들/XSN+을/JKO
위한	위하/VV+ㄴ/ETM
수화통역을	수화통역/NNG+을/JKO
실시간으로	실시간/NNG+으로/JKB
진행했다	진행하/VV+였/EP+다/EF

대한민국헌법	대한민국/NNP+헌법/NNG
제11조	제/XPN+11/SN+조/NNB
제1항에서는	제/XPN+1/SN+항/NNG+에서/JKB+는/JX
대한민국	대한민국/NNP
국민은	국민/NNG+은/JX
‘누구든지	‘/SN+누구/NP+든지/JX
정치적,	정치적/NNG+,/SP
경제적,	경제적/NNG+,/SP
사회적,	사회적/NNG+,/SP
문화적	문화적/NNG
생활의	생활/NNG+의/JKG
모든	모든/MM
영역에	영역/NNG+에/JKB
있어서	있/VA+어서/EC
차별을	차별/NNG+을/JKO
받지	받/VV+지/EC
아니한다’라고	아니/VCN+하/VV+ㄴ다’라고/EC
규정하고	규정하/VV+고/EC
있다	있/VX+다/EC

또한	또한/MAG
장애인차별금지	장애인차별금지/NNG
및	및/MAG
권리구제	권리구제/NNG
등에	등/NNB+에/JKB
관한	관하/VV+ㄴ/ETM
법률	법률/NNG
제21조에서도	제/XPN+21/SN+조/NNB+에서/JKB+도/JX
정보통신·의사소통	정보통신/NNG+·/SP+의사소통/NNG
등에서	등/NNB+에서/JKB
정당한	정당하/VA+ㄴ/ETM
편의제공의무를	편의제공의무/NNG+를/JKO
명시함으로써	명시하/VV+ㅁ/ETN+으로써/JKB
장애인이	장애인/NNG+이/JKS
비장애인과	비장애인/NNG+과/JKB
같은	같/VA+은/ETM
동등한	동등하/VA+ㄴ/ETM
정보습득이	정보습득/NNG+이/JKS
이루어지도록	이루어지/VV+도록/EC
하고	하/VX+고/EC
있다	있/VX+다/EC

하지만	하지만/MAJ
지난	지나/VV+ㄴ/ETM
4월	4/SN+월/NNB
총선	총선/NNG
당시	당시/NNG
본회에서	본회/NNG+에서/JKB
제기한	제기하/VV+ㄴ/ETM
후보자	후보자/NNG
토론회	토론회/NNG
당시	당시/NNG
수화통역	수화통역/NNG
및	및/MAG
자막방송	자막방송/NNG
제공	제공/NNG
등	등/NNB
청각장애인	청각장애인/NNG
참정권	참정권/NNG
확보를	확보/NNG+를/JKO
위한	위하/VV+ㄴ/ETM
제안은	제안/NNG+은/JX
제대로	제대로/MAG
반영되지	반영되/VV+지/EC
않았을뿐	않/VX+았/EP+을/ETM+뿐/NNB
더러,	덜/VV+러/EC+,/SP
각	각/MM
정당의	정당/NNG+의/JKG
대선후보자의	대선후보자/NNG+의/JKG
연설이나	연설/NNG+이나/JC
정책발표	정책발표/NNG
현장	현장/NNG
어느	어느/MM
곳에도	곳/NNG+에/JKB+도/JX
수화통역은	수화통역/NNG+은/JX
제공되지	제공되/VV+지/EC
않는다는게	않/VX+는다는/ETM+것/NNB+이/JKS
이들의	이/NP+들/XSN+의/JKG
설명	설명/NNG

협회는	협회/NNG+는/JX
20일	20/SN+일/NNB
성명서를	성명서/NNG+를/JKO
통해	통하/VV+여/EC
“이러한	“/SL+이러하/VA+ㄴ/ETM
상황에서	상황/NNG+에서/JKB
안철수	안철수/NNP
후보의	후보/NNG+의/JKG
대선출마	대선출마/NNG
기자회견	기자회견/NNG
당시	당시/NNG
수화통역	수화통역/NNG
제공은	제공/NNG+은/JX
몹시	몹시/MAG
의미있는	의미/NNG+있/VA+는/ETM
일이다	일/NNG+이/VCP+다/EC

평소	평소/NNG
정보	정보/NNG
접근권에	접근권/NNG+에/JKB
극심한	극심하/VA+ㄴ/ETM
차별을	차별/NNG+을/JKO
겪고	겪/VV+고/EC
있는	있/VX+는/ETM
우리	우리/NP
35만	35/SN+만/NR
농아인들에	농아인/NNG+들/XSN+에/JKB
대한	대하/VV+ㄴ/ETM
존중과	존중/NNG+과/JC
배려가	배려/NNG+가/JKS
묻어난	묻어나/VV+ㄴ/ETM
것으로	것/NNB+으로/JKB
매우	매우/MAG
바람직한	바람직하/VA+ㄴ/ETM
일이며	일/NNG+이/VCP+며/EC
환영하는	환영하/VV+는/ETM
바”라고	바”/NNG+이/VCP+라고/EC
설명했다	설명하/VV+었/EP+다/EC

이어	이어/MAG
협회는	협회/NNG+는/JX
“선거	“/SN+선거/NNG
관련	관련/NNG
정보를	정보/NNG+를/JKO
제공받지	제공/NNG+받/VV+지/EC
못한	못하/VX+ㄴ/ETM
농아인	농아/NNG+이/VCP+ㄴ/ETM
유권자는	유권자/NNG+는/JX
자연스레	자연스레/MAG
선거에	선거/NNG+에/JKB
대한	대하/VV+ㄴ/ETM
관심이	관심/NNG+이/JKS
멀어지게	멀어지/VV+게/EC
된다	되/VV+ㄴ다/EF

이는	이/NP+는/JX
우리	우리/NP
농아인들의	농아인/NNG+들/XSN+의/JKG
참정권을	참정권/NNG+을/JKO
심각하게	심각하/VA+게/EC
제한하는	제한하/VV+는/ETM
행위로	행위/NNG+로/JKB
반드시	반드시/MAG
고쳐져야	고치/VV+어/EC+지/VX+어야/EC
할	하/VX+ㄹ/ETM
사안”이라며	사안”/NNG+이/VCP+라며/EC
“대통령후보자의	“/SL+대통령후보자/NNG+의/JKG
공약을	공약/NNG+을/JKO
꼼꼼하게	꼼꼼하/VA+게/EC
따져보고	따지/VV+어/EC+보/VX+고/EC
대한민국의	대한민국/NNP+의/JKG
미래를	미래/NNG+를/JKO
선택하는	선택하/VV+는/ETM
소중한	소중하/VA+ㄴ/ETM
한	한/MM
표를	표/NNG+를/JKO
행사할	행사하/VV+ㄹ/ETM
수	수/NNB
있도록	있/VA+도록/EC
선거에	선거/NNG+에/JKB
있어서	있/VA+어서/EC
수화통역,	수화통역/NNG+,/SP
자막방송의	자막방송/NNG+의/JKG
확대와	확대/NNG+와/JC
농아인들을	농아인/NNG+들/XSN+을/JKO
위한	위하/VV+ㄴ/ETM
근본적인	근본적/NNG+이/VCP+ㄴ/ETM
정책을	정책/NNG+을/JKO
마련해줘야	마련하/VV+여/EC+주/VX+어야/EC
한다”고	하/VX+ㄴ다”고/EC
촉구했다	촉구하/VV+였/EP+다/EC
