‘2012	‘/SL+2012/SN
한국장애인인권상’	한국/NNP+장애인인권/NNG+상/XSN+’/SN
시상식	시상식/NNG
열려	열리/VV+어/EC

한국장애인인권상위원회는	한국/NNP+장애인인권상위원회/NNG+는/JX
3일	3/SN+일/NNB
오후	오후/NNG
2시	2/SN+시/NNB
이룸센터에서	이룸센터/NNG+에서/JKB
‘인권의	‘/SN+인권/NNG+의/JKG
등불로	등불/NNG+로/JKB
차별없는	차별없/VA+는/ETM
세상을’	세상/NNG+을/JKO+’/VV
주제	주제/NNG
아래	아래/NNG
‘2012	‘/SL+2012/SN
한국장애인인권상	한국/NNP+장애인인권/NNG+상/XSN
시상식’을	시상식/NNG+’/SL+을/JKO
개최했다	개최하/VV+였/EP+다/EC

시상식에서	시상식/NNG+에서/JKB
서울특별시	서울특별시/NNP
송파구(기초자치),	송파구/NNP+(/SS+기초자치/NNG+)/SS+,/SP
충남지방경찰청(공공기관),	충남/NNP+지방경찰청/NNG+(/SS+공공기관/NNG+)/SS+,/SP
광주광역시(인권정책),	광주광역시/NNP+(/SS+인권정책/NNG+)/SS+,/SP
장애여성네트워크(인권실천),	장애여성네트워크/NNP+(/SS+인권실천/NNG+)/SS+,/SP
함께걸음(인권매체)이	함께/MAG+걸/VV+음/ETN+(/SS+인권매체/NNG+)/SS+이/JKS
각	각/MM
부문	부문/NNG
수상의	수상/NNG+의/JKG
영예를	영예/NNG+를/JKO
안았다	안/VV+았/EP+다/EC

이날	이날/NNG
변승일	변승일/NNP
한국장애인인권상위원회	한국장애인인권상위원회/NNP
공동위원장(한국장애인단체총연맹	공동위원장/NNG+(/SS+한국/NNP+장애인단체총연맹/NNG
상임대표)은	상임대표/NNG+)/SS+은/JX
기념사를	기념사/NNG+를/JKO
통해	통하/VV+여/EC
“장애인들에	“/SL+장애인/NNG+들/XSN+에/JKB
대한	대하/VV+ㄴ/ETM
사회의	사회/NNG+의/JKG
잘못된	잘못되/VV+ㄴ/ETM
편견으로	편견/NNG+으로/JKB
인해	인하/VV+여/EC
어려운	어렵/VA+ㄴ/ETM
삶	삶/NNG
살고	살/VV+고/EC
있다”며	있/VX+다/EC+”/VX+며/EC
“12월	“/SL+12/SN+월/NNB
3일	3/SN+일/NNB
UN이	UN/SL+이/JKS
지정한	지정하/VV+ㄴ/ETM
세계장애인의	세계장애인/NNG+의/JKG
날을	날/NNG+을/JKO
기념하기	기념하/VV+기/ETN
위해	위하/VV+여/EC
한국장애인인권상을	한국/NNP+장애인인권상/NNG+을/JKO
수여하게	수여하/VV+게/EC
됐다	되/VV+었/EP+다/EC

현장에서	현장/NNG+에서/JKB
장애인	장애인/NNG
차별과	차별/NNG+과/JC
사회통합,	사회통합/NNG+,/SP
비장애인과	비장애인/NNG+과/JKB
동등한	동등하/VA+ㄴ/ETM
권리를	권리/NNG+를/JKO
누릴	누리/VV+ㄹ/ETM
수	수/NNB
있는	있/VA+는/ETM
환경을	환경/NNG+을/JKO
조성하기	조성하/VV+기/ETN
위해	위하/VV+여/EC
노력해	노력하/VV+여/EC
온	오/VX+ㄴ/ETM
많은	많/VA+은/ETM
분들의	분/NNB+들/XSN+의/JKG
노고를	노고/NNG+를/JKO
치하한다”고	치하하/VV+ㄴ다”고/EC
격려했다	격려하/VV+였/EP+다/EF

박춘희	박춘희/NNP
송파구청장은	송파구청/NNG+장/XSN+은/JX
“수상을	“/SL+수상/NNG+을/JKO
받아	받/VV+아/EC
기쁘기도	기쁘/VA+기/ETN+도/JX
하지만	하/VX+지만/EC
한편으로는	한편/NNG+으로/JKB+는/JX
장애인	장애인/NNG
스스로	스스로/MAG
인권	인권/NNG
더욱	더욱/MAG
잘	잘/MAG
지켜달라는	지키/VV+어/EC+달/VX+라는/ETM
의미가	의미/NNG+가/JKS
담겨져	담기/VV+어/EC+지/VX+어/EC
있다고	있/VX+다고/EC
생각	생각/NNG
돼	되/VV+어/EC
책임감이	책임감/NNG+이/JKS
무거워진다	무겁/VA+어/EC+지/VX+ㄴ다/EF

다가가는	다가가/VV+는/ETM
장애인	장애인/NNG
복지	복지/NNG
행정을	행정/NNG+을/JKO
구현해	구현하/VV+여/EC
장애인이	장애인/NNG+이/JKS
가장	가장/MAG
살기	살/VV+기/ETN
좋은	좋/VA+은/ETM
구로	구로/NNP
평가받을	평가/NNG+받/VV+을/ETM
수	수/NNB
있도록	있/VA+도록/EC
노력하겠다”고	노력하/VV+겠/EP+다/EC+”/SN+고/EC
포부를	포부/NNG+를/JKO
밝혔다	밝히/VV+었/EP+다/EC

윤철규	윤철규/NNP
충남지방경찰청장도	충남/NNP+지방경찰청/NNG+장/XSN+도/JX
“앞으로도	“/SN+앞/NNG+으로/JKB+도/JX
충남경찰은	충남/NNP+경찰/NNG+은/JX
장애인의	장애인/NNG+의/JKG
안전과	안전/NNG+과/JC
권익증진	권익증진/NNG
등	등/NNB
소외됨이	소외되/VV+ㅁ/ETN+이/JKS
없는	없/VA+는/ETM
치안	치안/NNG
복지	복지/NNG
실현을	실현/NNG+을/JKO
위해	위하/VV+여/EC
최선을	최선/NNG+을/JKO
다하겠다”고	다하/VV+겠/EP+다/EC+”/SN+고/EC
강조했다	강조하/VV+였/EP+다/EC

장애인인권상위원회는	장애인인권상위원회/NNG+는/JX
매년	매년/MAG
12월	12/SN+월/NNB
3일	3/SN+일/NNB
세계장애인의	세계장애인/NNG+의/JKG
날을	날/NNG+을/JKO
맞이해	맞이하/VV+여/EC
UN이	UN/SL+이/JKS
천명한	천명하/VV+ㄴ/ETM
장애인권리선언(1975)과	장애인권리선언/NNG+(/SS+1975/SN+)/SS+과/JC
대한민국	대한민국/NNP
정부가	정부/NNG+가/JKS
선포한	선포하/VV+ㄴ/ETM
장애인인권헌장(1998)의	장애인인권헌장/NNG+(/SS+1998/SN+)/SS+의/JKG
이념을	이념/NNG+을/JKO
반영하고,	반영하/VV+고/EC+,/SP
장애인차별금지법의	장애인차별금지법/NNG+의/JKG
실천을	실천/NNG+을/JKO
이뤄	이루어/VV
낸	내/VX+ㄴ/ETM
개인	개인/NNG
및	및/MAG
단체를	단체/NNG+를/JKO
대상으로	대상/NNG+으로/JKB
시상하고	시상하/VV+고/EC
있다	있/VX+다/EC

한편	한편/MAG
시상식	시상식/NNG
이후에는	이후/NNG+에/JKB+는/JX
'2012장애인식개선	'/SS+2012/SN+장애인식개선/NNG
웹툰	웹툰/NNG
공모전'	공모전/NNG+'/SS
수상자에	수상자/NNG+에/JKB
대한	대하/VV+ㄴ/ETM
시상이	시상/NNG+이/JKS
진행됐다	진행되/VV+었/EP+다/EF

승지혜	승지혜/NNP
씨의	씨/NNB+의/JKG
‘우리는	‘/SL+우리/NP+는/JX
이웃입니다’가	이웃/NNG+이/VCP+ㅂ니다/EF+’/SL+가/JKS
최우수상,	최우수상/NNG+,/SP
정동호	정동호/NNP
씨의	씨/NNB+의/JKG
‘길’이	‘길/SN+’/SL+이/JKS
우수상,	우수상/NNG+,/SP
김다영	김다영/NNP
씨의	씨/NNB+의/JKG
‘무장애올림픽’이	‘/SL+무장애올림픽/NNG+’/SL+이/JKS
장려상을	장려상/NNG+을/JKO
각각	각각/MAG
받았다	받/VV+았/EP+다/EC

한국장애인인권상	한국/NNP+장애인인권/NNG+상/XSN
인권매체	인권매체/NNG
부문을	부문/NNG+을/JKO
시상한	시상하/VV+ㄴ/ETM
현대홈쇼핑	현대홈쇼핑/NNP
김인권	김인권/NNP
사장과	사장/NNG+과/JC
수상의	수상/NNG+의/JKG
기쁨을	기쁨/NNG+을/JKO
누린	누리/VV+ㄴ/ETM
함께걸음의	함께/MAG+걸/VV+음/ETN+의/JKG
이태곤	이태곤/NNP
편집장,	편집장/NNG+,/SP
김성재	김성재/NNP
발행인	발행인/NNG
(좌측부터)	(/SS+좌측/NNG+부터/JX+)/SS

시상식이	시상식/NNG+이/JKS
끝난	끝나/VV+ㄴ/ETM
뒤	뒤/NNG
축하케이크를	축하케이크/NNG+를/JKO
자르는	자르/VV+는/ETM
한국장애인인권상	한국/NNP+장애인인권/NNG+상/XSN
수상자들과	수상자/NNG+들/XSN+과/JC
주요내빈들	주요내빈/NNG+들/XSN
