장애인	장애인/NNG
보험가입시	보험가입/NNG+시/NNB
보조인	보조/NNG+이/VCP+ㄴ/ETM
신분증	신분증/NNG
요구	요구/NNG
‘차별’	‘/SN+차별/NNG+’/SN

국가인권위원회(위원장	국가인권위원회/NNG+(/SS+위원장/NNG
현병철)는	현병철/NNP+)/SS+는/JX
29일	29/SN+일/NNB
시각장애인	시각장애인/NNG
본인이	본인/NNG+이/JKS
보험	보험/NNG
계약체결을	계약체결/NNG+을/JKO
위해	위하/VV+여/EC
직접	직접/MAG
방문했음에도	방문하/VV+였/EP+음/ETN+에/JKB+도/JX
불구하고	불구하/VV+고/EC
A보증보험사가	A/SL+보증보험사/NNG+가/JKS
보험계약	보험계약/NNG
당사자도	당사자/NNG+도/JX
아닌	아니/VCN+ㄴ/ETM
활동보조인에게	활동보조인/NNG+에게/JKB
신분증을	신분증/NNG+을/JKO
요구한	요구하/VV+ㄴ/ETM
뒤	뒤/NNG
활동보조인의	활동보조인/NNG+의/JKG
신분증이	신분증/NNG+이/JKS
없다는	없/VA+다는/ETM
이유로	이유/NNG+로/JKB
보험계약	보험계약/NNG
체결을	체결/NNG+을/JKO
거부한	거부하/VV+ㄴ/ETM
것은	것/NNB+은/JX
장애인	장애인/NNG
‘차별’	‘/SN+차별/NNG+’/SN
행위라고	행위/NNG+이/VCP+라고/EC
밝혔다	밝히/VV+었/EP+다/EC

이어	이어/MAG
금융위원회위원장과	금융위원회위원장/NNG+과/JC
금융감독원장에게	금융감독원장/NNG+에게/JKB
유사	유사/NNG
사례가	사례/NNG+가/JKS
재발하지	재발하/VV+지/EC
않도록	않/VX+도록/EC
제도개선과	제도개선/NNG+과/JC
함께	함께/MAG
A보증보험사에	A/SL+보증보험사/NNG+에/JKB
대한	대하/VV+ㄴ/ETM
지도·감독을	지도/NNG+·/SP+감독/NNG+을/JKO
철저히	철저히/MAG
할	하/VV+ㄹ/ETM
것을	것/NNB+을/JKO
권고했다	권고하/VV+였/EP+다/EC

인권위에	인권위/NNG+에/JKB
따르면	따르/VV+면/EC
진정인	진정/NNG+이/VCP+ㄴ/ETM
박모(여,	박/NNP+모/NP+(/SS+여/NNG+,/SP
54세,	54/SN+세/NNB+,/SP
시각장애)씨는	시각장애/NNG+)/SS+씨/NNB+는/JX
지난	지나/VV+ㄴ/ETM
4월	4/SN+월/NNB
“3월	“3/SN+월/NNB
A사	A/SL+사/NNG
지점을	지점/NNG+을/JKO
방문해	방문하/VV+여/EC
자신의	자신/NNG+의/JKG
명의로	명의/NNG+로/JKB
이행보증보험(전대차계약(월세	이행보증보험/NNG+(/SS+전대차계약/NNG+(/SS+월세/NNG
등	등/NNB
지급계약)을	지급계약/NNG+)/SS+을/JKO
가입하고자	가입하/VV+고자/EC
서류를	서류/NNG+를/JKO
모두	모두/MAG
갖춰	갖추/VV+어/EC
제출했으나,	제출하/VV+였/EP+으나/EC+,/SP
A사가	A/SL+사/NNG+가/JKS
진정인을	진정인/NNG+을/JKO
동행한	동행하/VV+ㄴ/ETM
활동보조인의	활동보조인/NNG+의/JKG
신분증이	신분증/NNG+이/JKS
없다는	없/VA+다는/ETM
이유로	이유/NNG+로/JKB
계약체결을	계약체결/NNG+을/JKO
거절했다”며	거절하/VV+였/EP+다/EC+”/VX+며/EC
인권위에	인권위/NNG+에/JKB
진정을	진정/NNG+을/JKO
제기했다	제기하/VV+였/EP+다/EC

이에	이/NP+에/JKB
대해	대하/VV+여/EC
A사는	A/SL+사/NNG+는/JX
진정인이	진정인/NNG+이/JKS
시각장애인이기	시각장애인/NNG+이/VCP+기/ETN
때문에	때문/NNB+에/JKB
청약서류를	청약서류/NNG+를/JKO
직접	직접/MAG
볼	보/VV+ㄹ/ETM
수	수/NNB
없어	없/VA+어/EC
동행한	동행하/VV+ㄴ/ETM
활동보조인에게	활동보조인/NNG+에게/JKB
청약내용을	청약내용/NNG+을/JKO
설명해주고,	설명하/VV+여/EC+주/VX+고/EC+,/SP
그에	그/NP+에/JKB
대한	대하/VV+ㄴ/ETM
확인을	확인/NNG+을/JKO
위해	위하/VV+여/EC
활동보조인의	활동보조인/NNG+의/JKG
신분증을	신분증/NNG+을/JKO
요청하게	요청하/VV+게/EC
된	되/VV+ㄴ/ETM
것이라고	것/NNB+이/VCP+라고/EC
설명했다	설명하/VV+었/EP+다/EC

또한	또한/MAG
이는	이/NP+는/JX
‘보험업법’에	‘/SN+보험업법/NNG+’/SL+에/JKB
따라	따르/VV+아/EC
보험계약자가	보험계약자/NNG+가/JKS
보험계약	보험계약/NNG
내용에	내용/NNG+에/JKB
대한	대하/VV+ㄴ/ETM
설명을	설명/NNG+을/JKO
듣고	듣/VV+고/EC
내용을	내용/NNG+을/JKO
이해하였음을	이해하/VV+였/EP+음/ETN+을/JKO
확인하기	확인하/VV+기/ETN
위한	위하/VV+ㄴ/ETM
것이며,	것/NNB+이/VCP+며/EC+,/SP
불완전	불완전/NNG
판매를	판매/NNG+를/JKO
방지하기	방지하/VV+기/ETN
위한	위하/VV+ㄴ/ETM
목적이라고	목적/NNG+이/VCP+라고/EC
밝혔다	밝히/VV+었/EP+다/EC

당일	당일/NNG
오후	오후/NNG
설계사가	설계사/NNG+가/JKS
진정인을	진정인/NNG+을/JKO
방문해	방문하/VV+여/EC
활동보조인의	활동보조인/NNG+의/JKG
신분증을	신분증/NNG+을/JKO
확인한	확인하/VV+ㄴ/ETM
후	후/NNG
보험계약을	보험계약/NNG+을/JKO
체결했다고	체결하/VV+였/EP+다고/EC
덧붙였다	덧붙이/VV+었/EP+다/EF

하지만	하지만/MAJ
인권위는	인권위/NNG+는/JX
활동보조인이	활동보조인/NNG+이/JKS
보험계약	보험계약/NNG
체결	체결/NNG
등과	등/NNB+과/JKB
같은	같/VA+은/ETM
법률행위에	법률행위/NNG+에/JKB
유효한	유효하/VA+ㄴ/ETM
법률행위를	법률행위/NNG+를/JKO
할	하/VV+ㄹ/ETM
자격이	자격/NNG+이/JKS
없고,	없/VA+고/EC+,/SP
현실적으로	현실적/NNG+으로/JKB
청약관련	청약관련/NNG
서류를	서류/NNG+를/JKO
눈으로	눈/NNG+으로/JKB
확인하지	확인하/VV+지/EC
않고도	않/VX+고도/EC
전화상을	전화상/NNG+을/JKO
통해	통하/VV+여/EC
보험계약이	보험계약/NNG+이/JKS
이뤄지고	이루어지/VV+고/EC
있다는	있/VX+다는/ETM
점	점/NNG
등을	등/NNB+을/JKO
고려해	고려하/VV+여/EC
활동보조인의	활동보조인/NNG+의/JKG
신분증이	신분증/NNG+이/JKS
없다는	없/VA+다는/ETM
이유로	이유/NNG+로/JKB
당초	당초/NNG
보험계약체결을	보험계약체결/NNG+을/JKO
거부한	거부하/VV+ㄴ/ETM
행위는	행위/NNG+는/JX
장애를	장애/NNG+를/JKO
이유로	이유/NNG+로/JKB
한	하/VV+ㄴ/ETM
차별행위에	차별행위/NNG+에/JKB
해당된다고	해당되/VV+ㄴ다고/EC
판단했다	판단하/VV+였/EP+다/EC
