법원	법원/NNG
"입양딸	"/SS+입양딸/NNG
폭행치사	폭행치사/NNG
母,	母/SL+,/SP
남은	남/NNG+은/JX
아이	아이/NNG
친권도	친권도/NNG
박탈"	박탈/NNG+"/SS

(서울=연합뉴스)	(/SS+서울/NNP+=/SW+연합뉴스/NNP+)/SS
이상현	이상현/NNP
기자	기자/NNG
=	=/SW
입양한	입양하/VV+ㄴ/ETM
어린	어리/VA+ㄴ/ETM
딸을	딸/NNG+을/JKO
폭행해	폭행하/VV+여/EC
숨지게	숨지/VV+게/EC
한	하/VX+ㄴ/EF
여성이	여성/NNG+이/JKS
남은	남/VV+은/ETM
입양아에	입양아/NNG+에/JKB
대한	대하/VV+ㄴ/ETM
친권마저	친권/NNG+마저/JX
잃게	잃/VV+게/EC
됐다	되/VV+었/EP+다/EC

서울가정법원	서울/NNP+가정법원/NNG
가사합의2부(박종택	가사합의/NNG+2/SN+부/NNB+(/SS+박종택/NNP
부장판사)는	부장판사/NNG+)/SS+는/JX
상해치사	상해치사/NNP
혐의로	혐의/NNG+로/JKB
중형을	중형/NNG+을/JKO
선고받은	선고/NNG+받/VV+은/ETM
A씨(여)로부터	A/SL+씨/NNB+(/SS+여/NNG+)/SS+로부터/JKB
부모로서의	부모/NNG+로서/JKB+의/JKG
권리를	권리/NNG+를/JKO
박탈해달라는	박탈하/VV+여/EC+달/VX+라는/ETM
검사의	검사/NNG+의/JKG
친권상실선고	친권상실선고/NNG
청구를	청구/NNG+를/JKO
받아들였다고	받아들이/VV+었/EP+다고/EC
25일	25/SN+일/NNB
밝혔다	밝히/VV+었/EP+다/EC

지난	지나/VV+ㄴ/ETM
2009년	2009/SN+년/NNB
A씨는	A/SL+씨/NNB+는/JX
교제하던	교제하/VV+던/ETM
남성과의	남성/NNG+과/JKB+의/JKG
사이에서	사이/NNG+에서/JKB
임신한	임신하/VV+ㄴ/ETM
아이를	아이/NNG+를/JKO
유산하자,	유산하/VV+자/EC+,/SP
남성	남성/NNG
몰래	몰래/MAG
뇌병변장애	뇌병변장애/NNG
1급의	1/SN+급/NNG+의/JKG
장애아(남)를	장애아/NNG+(/SS+남/NNG+)/SS+를/JKO
입양한	입양하/VV+ㄴ/ETM
뒤	뒤/NNG
친자식인	친자식/NNG+이/VCP+ㄴ/ETM
것처럼	것/NNB+처럼/JKB
속여	속이/VV+어/EC
출생신고를	출생신고/NNG+를/JKO
했다	하/VV+였/EP+다/EF

A씨는	A/SL+씨/NNB+는/JX
이듬해	이듬해/NNG
생후	생후/NNG
3개월	3/SN+개월/NNB
된	되/VV+ㄴ/ETM
여자	여자/NNG
아이를	아이/NNG+를/JKO
다시	다시/MAG
입양했는데	입양하/VV+였/EP+는데/EC
이후	이후/NNG
수차례	수차례/NNG
구타해	구타하/VV+여/EC
뇌	뇌/NNG
손상을	손상/NNG+을/JKO
입혔고,	입허/VV+였/EP+고/EC+,/SP
이	이/MM
때문에	때문/NNB+에/JKB
결국	결국/NNG
아이가	아이/NNG+가/JKS
사망하면서	사망하/VV+면서/EC
상해치사	상해치사/NNP
혐의로	혐의/NNG+로/JKB
기소돼	기소되/VV+어/EC
대법원에서	대법원/NNG+에서/JKB
올해	올해/NNG
9월	9/SN+월/NNB
징역	징역/NNG
6년의	6/SN+년/NNB+의/JKG
확정판결을	확정판결/NNG+을/JKO
받았다	받/VV+았/EP+다/EC

이후	이후/NNG
A씨	A/SL+씨/NNB
가족들이	가족/NNG+들/XSN+이/JKS
입양아들을	입양아들/NNG+을/JKO
키우겠다고	키우/VV+겠/EP+다고/EC
주장했지만,	주장하/VV+었/EP+지만/EC+,/SP
어린이집을	어린이집/NNG+을/JKO
통학시키는	통학/NNG+시키/XSV+는/ETM
것	것/NNB
외에	외/NNB+에/JKB
별다른	별다르/VA+ㄴ/ETM
조치를	조치/NNG+를/JKO
취하지는	취하/VV+지/EC+는/JX
않았으며,	않/VX+았/EP+으며/EC+,/SP
이에	이/NP+에/JKB
아동보호전문기관은	아동보호전문기관/NNG+은/JX
아이를	아이/NNG+를/JKO
영아원으로	영아원/NNG+으로/JKB
격리했다	격리하/VV+였/EP+다/EC

재판부는	재판부/NNG+는/JX
"A씨는	"/SS+A/SL+씨/NNB+는/JX
자신이	자신/NNG+이/JKS
키우던	키우/VV+던/ETM
아이를	아이/NNG+를/JKO
별다른	별다르/VA+ㄴ/ETM
이유	이유/NNG
없이	없이/MAG
심하게	심하/VA+게/EC
구타해	구타하/VV+여/EC
사망에	사망/NNG+에/JKB
이르게	이르/VV+게/EC
함으로써	하/VX+ㅁ/ETN+으로써/JKB
유죄	유죄/NNG
판결을	판결/NNG+을/JKO
받아	받/VV+아/EC
장기간	장기간/NNG
수감	수감/NNG
생활을	생활/NNG+을/JKO
해야	하/VV+여야/EC
한다"고	하/VX+ㄴ다/EF+"/SS+고/JKQ
전제했다	전제하/VV+였/EP+다/EC

이어	이어/MAG
"아이가	"/SS+아이/NNG+가/JKS
향후	향후/NNG
지속적인	지속적/NNG+이/VCP+ㄴ/ETM
재활치료를	재활치료/NNG+를/JKO
받아야	받/VV+아야/EC
하는	하/VX+는/ETM
중증	중증/NNG
장애를	장애/NNG+를/JKO
지녔는데	지니/VV+었/EP+는데/EC
치료를	치료/NNG+를/JKO
위해	위하/VV+여/EC
노력할	노력하/VV+ㄹ/ETM
수	수/NNB
없는	없/VA+는/ETM
형편인	형편/NNG+이/VCP+ㄴ/ETM
점을	점/NNG+을/JKO
고려하면,	고려하/VV+면/EC+,/SP
A씨가	A/SL+씨/NNB+가/JKS
아이의	아이/NNG+의/JKG
건전한	건전하/VA+ㄴ/ETM
성장을	성장/NNG+을/JKO
위해	위하/VV+여/EC
적절하게	적절하/VA+게/EC
친권을	친권/NNG+을/JKO
행사하리라	행사하/VV+리라/EC
기대할	기대하/VV+ㄹ/ETM
수	수/NNB
없다"고	없/VA+다/EF+"/SS+고/JKQ
강조했다	강조하/VV+였/EP+다/EC

hapyry@yna	hapyry/SL+@/SW+yna/SL

co	co/SL

kr<저	kr/SL+</SS+저/MM
작	작/NNG
권	권/NNP
자(c)연	자/NP+(/SS+c/SL+)/SS+연/NNG
합	합/NNG
뉴	뉴/NNG
스	스/NNG

무	무/NNG
단	단/MM
전	전/NNG
재-재	재/NNG+-/SO+재/NNG
배	배/NNG
포	포/NNG
금	금/VV
지	짓/VV

>	>/SS
