사회복지법인	사회복지법인/NNG
등	등/NNB
지방세	지방세/NNG
영구면제	영구면제/NNG
추진	추진/NNG

국회	국회/NNG
보건복지위원회	보건복지위원회/NNG
소속	소속/NNG
최동익	최동익/NNP
의원(민주통합당)은	의원/NNG+(/SS+민주통합당/NNP+)/SS+은/JX
사회복지법인	사회복지법인/NNG
등에	등/NNB+에/JKB
적용되는	적용되/VV+는/ETM
지방세	지방세/NNG
특례를	특례/NNG+를/JKO
지속적으로	지속적/NNG+으로/JKB
유지하기	유지하/VV+기/ETN
위해	위하/VV+여/EC
'지방세특례제한법	'/SS+지방세특례제한법/NNG
일부개정법률안'을	일부개정법률안/NNG+'/SS+을/JKO
29일	29/SN+일/NNB
대표발의했다	대표/NNG+발의하/VV+였/EP+다/EF

사회복지법인	사회복지법인/NNG
등은	등/NNB+은/JX
국가를	국가/NNG+를/JKO
대신해	대신하/VV+여/EC
사회복지서비스를	사회복지서비스/NNG+를/JKO
공급하는	공급하/VV+는/ETM
민간주체로서의	민간주체/NNG+로서/JKB+의/JKG
역할을	역할/NNG+을/JKO
수행하고	수행하/VV+고/EC
있다	있/VX+다/EC

또한	또한/MAG
시설	시설/NNG
신축비,	신축비/NNG+,/SP
운영비를	운영비/NNG+를/JKO
국고보조금으로	국고보조금/NNG+으로/JKB
지원받으며,	지원/NNG+받/VV+으며/EC+,/SP
해산할	해산하/VV+ㄹ/ETM
경우	경우/NNG
사회복지법인의	사회복지법인/NNG+의/JKG
잔여재산은	잔여재산/NNP+은/JX
국가	국가/NNG
또는	또는/MAG
지방자치단체에	지방자치단체/NNG+에/JKB
귀속되도록	귀속되/VV+도록/EC
규정하고	규정하/VV+고/EC
있는	있/VX+는/ETM
비영리	비/XPN+영리/NNG
공익법인의	공익법인/NNG+의/JKG
형태이다	형태/NNG+이/VCP+다/EC

이러한	이러하/VA+ㄴ/ETM
점을	점/NNG+을/JKO
감안해	감안하/VV+여/EC
현행	현행/NNG
세법에서는	세법/NNG+에서/JKB+는/JX
사회복지법인,	사회복지법인/NNG+,/SP
양로원,	양로원/NNG+,/SP
보육원,	보육원/NNG+,/SP
모자원,	모자원/NNG+,/SP
한센병자	한센/NNP+병자/NNG
치료보호시설	치료보호시설/NNG
등	등/NNB
사회복지단체가	사회복지단체/NNG+가/JKS
복지사업에	복지사업/NNG+에/JKB
사용하기	사용하/VV+기/ETN
위해	위하/VV+여/EC
부동산을	부동산/NNG+을/JKO
취득할	취득하/VV+ㄹ/ETM
경우	경우/NNG
취득세가	취득세/NNG+가/JKS
전액	전액/NNG
면제된다	면제되/VV+ㄴ다/EF

또한	또한/MAG
복지사업에	복지사업/NNG+에/JKB
직접	직접/MAG
사용하는	사용하/VV+는/ETM
건축물과	건축물/NNG+과/JC
부속토지에	부속토지/NNG+에/JKB
대해서는	대하/VV+여서/EC+는/JX
재산세와	재산세/NNG+와/JC
지역자원시설세도	지역자원시설세/NNG+도/JX
비과세	비과세/NNG
혜택이	혜택/NNG+이/JKS
적용된다	적용되/VV+ㄴ다/EC

복지사업을	복지사업/NNG+을/JKO
위해	위하/VV+여/EC
활용하는	활용하/VV+는/ETM
면허에	면허/NNG+에/JKB
대한	대하/VV+ㄴ/ETM
등록면허세와	등록면허세/NNG+와/JC
사회복지법인에	사회복지법인/NNG+에/JKB
과세되는	과세/NNG+되/XSV+는/ETM
주민세(재산세)	주민세/NNG+(/SS+재산세/NNG+)/SS
및	및/MAG
지방소득세(종업원분)도	지방소득세/NNG+(/SS+종업원분/NNG+)/SS+도/JX
과세되지	과세/NNG+되/XSV+지/EC
않는다	않/VX+는다/EF

그런데	그런데/MAJ
문제는	문제/NNG+는/JX
현행법	현행법/NNG
상	상/NNG
이러한	이러하/VA+ㄴ/ETM
면제	면제/NNG
특례가	특례/NNG+가/JKS
일몰제로	일몰/NNG+제/XSN+로/JKB
되어	되/VV+어/EC
있어	있/VX+어/EC
올해	올해/NNG
말이면	말/NNB+이/VCP+면/EC
사회복지법인	사회복지법인/NNG
등의	등/NNB+의/JKG
지방세	지방세/NNG
면제혜택이	면제혜택/NNG+이/JKS
끝나게	끝나/VV+게/EC
된다는	되/VV+ㄴ다는/ETM
점	점/NNG

정부는	정부/NNG+는/JX
지방재정의	지방재정/NNG+의/JKG
건전성을	건전성/NNG+을/JKO
강화한다는	강화하/VV+ㄴ다는/ETM
명분을	명분/NNG+을/JKO
내세우고	내세우/VV+고/EC
있으나,	있/VX+으나/EC+,/SP
사회복지	사회복지/NNG
현장에서는	현장/NNG+에서/JKB+는/JX
면세	면세/NNG
혜택이	혜택/NNG+이/JKS
없어지면	없어지/VV+면/EC
시설	시설/NNG
운영에	운영/NNG+에/JKB
심각한	심각하/VA+ㄴ/ETM
문제가	문제/NNG+가/JKS
발생할	발생하/VV+ㄹ/ETM
것으로	것/NNB+으로/JKB
우려된다고	우려되/VV+ㄴ다고/EC
최	최/NNP
의원은	의원/NNG+은/JX
설명했다	설명하/VV+었/EP+다/EC

최동익	최동익/NNP
의원은	의원/NNG+은/JX
"최근	"/SS+최근/NNG
사회복지	사회복지/NNG
수요의	수요/NNG+의/JKG
증가에	증가/NNG+에/JKB
따라	따르/VV+아/EC
이들	이/NP+들/XSN
사회복지법인	사회복지법인/NNG
등의	등/NNB+의/JKG
사회안전망으로서의	사회안전망/NNG+으로서/JKB+의/JKG
역할이	역할/NNG+이/JKS
더욱	더욱/MAG
절실한	절실하/VA+ㄴ/ETM
상황이라는	상황/NNG+이/VCP+라는/ETM
점을	점/NNG+을/JKO
고려할	고려하/VV+ㄹ/ETM
때,	때/NNG+,/SP
사회복지법인	사회복지법인/NNG
등에	등/NNB+에/JKB
대한	대하/VV+ㄴ/ETM
지방세특례는	지방세특례/NNG+는/JX
지속적으로	지속적/NNG+으로/JKB
유지될	유지되/VV+ㄹ/ETM
필요가	필요/NNG+가/JKS
있다"며	있/VA+다/EF+"/SS+며/EC
"사회복지법인	"/SS+사회복지법인/NNG
등이	등/NNB+이/JKS
영구적으로	영구적/NNG+으로/JKB
지방세특례를	지방세특례/NNG+를/JKO
받을	받/VV+을/ETM
수	수/NNB
있도록	있/VA+도록/EC
취득세,	취득세/NNG+,/SP
재산세,	재산세/NNG+,/SP
등록면허세,	등록면허세/NNG+,/SP
지역자원시설세	지역자원시설세/NNG
등	등/NNB
지방세	지방세/NNG
면제	면제/NNG
혜택의	혜택/NNG+의/JKG
일몰기한을	일몰기한/NNG+을/JKO
아예	아예/MAG
삭제해야	삭제하/VV+여야/EC
한다"고	하/VX+ㄴ다/EF+"/SS+고/JKQ
강조했다	강조하/VV+였/EP+다/EC
